count$path$bad_name$	suggested_name
    2$_NO_HIGHERTAXON$Abuyogocoris calian$	Abuyogocoris sp_ms_calian
    4$_NO_HIGHERTAXON$Abuyogocoris sp.$	Abuyogocoris sp.
    1$_NO_HIGHERTAXON$Abuyogocoris tawitawi$	Abuyogocoris sp_ms_tawitawi
    2$_NO_HIGHERTAXON$Acaciacapsus amadeus$	Acaciacapsus sp_ms_amadeus
   26$_NO_HIGHERTAXON$Acaciacapsus appha$	Acaciacapsus sp_ms_appha
   24$_NO_HIGHERTAXON$Acaciacapsus aureolus$	Acaciacapsus sp_ms_aureolus
   29$_NO_HIGHERTAXON$Acaciacapsus bournda$	Acaciacapsus sp_ms_bournda
    7$_NO_HIGHERTAXON$Acaciacapsus emeraldensis$	Acaciacapsus sp_ms_emeraldensis
    9$_NO_HIGHERTAXON$Acaciacapsus lolworthensis$	Acaciacapsus sp_ms_lolworthensis
    2$_NO_HIGHERTAXON$Acaciacapsus millstreamensis$	Acaciacapsus sp_ms_millstreamensis
    3$_NO_HIGHERTAXON$Acaciacapsus woodwardi$	Acaciacapsus sp_ms_woodwardi
    1$_NO_HIGHERTAXON$Acrorrhinium bismarkensis$	Acrorrhinium sp_ms_bismarkensis
    1$_NO_HIGHERTAXON$Acrorrhinium monoceros$	Acrorrhinium sp_ms_monoceros
    2$_NO_HIGHERTAXON$Acrorrhinium spicatus$	Acrorrhinium sp_ms_spicatus
    1$_NO_HIGHERTAXON$Acrotelus canariensis$	Acrotelus sp_ms_canariensis
   41$_NO_HIGHERTAXON$Adunatiphylus kalbarri$	Adunatiphylus sp_ms_kalbarri
   29$_NO_HIGHERTAXON$Aeptini sp_gen1_sp1$	Aeptini sp_gen1_sp1
   22$_NO_HIGHERTAXON$Agramma pictipenne$	Agramma sp_ms_pictipenne
    6$_NO_HIGHERTAXON$Agramma sp$	Agramma sp
    7$_NO_HIGHERTAXON$Agramma sp_ms_alpinus$	Agramma sp_ms_alpinus
  155$_NO_HIGHERTAXON$Agramma sp_ms_bicolor$	Agramma sp_ms_bicolor
    2$_NO_HIGHERTAXON$Agramma sp_ms_dalby$	Agramma sp_ms_dalby
  134$_NO_HIGHERTAXON$Agramma sp_ms_donaldsoni$	Agramma sp_ms_donaldsoni
    3$_NO_HIGHERTAXON$Agramma sp_ms_exiguum$	Agramma sp_ms_exiguum
    3$_NO_HIGHERTAXON$Agramma sp_ms_halfpappi$	Agramma sp_ms_halfpappi
    1$_NO_HIGHERTAXON$Agramma sp_ms_horni$	Agramma sp_ms_horni
   17$_NO_HIGHERTAXON$Agramma sp_ms_inceratus$	Agramma sp_ms_inceratus
   95$_NO_HIGHERTAXON$Agramma sp_ms_kinchega$	Agramma sp_ms_kinchega
    6$_NO_HIGHERTAXON$Agramma sp_ms_nebo$	Agramma sp_ms_nebo
    3$_NO_HIGHERTAXON$Agramma sp_ms_pilbara$	Agramma sp_ms_pilbara
    2$_NO_HIGHERTAXON$Agramma sp_ms_postlei$	Agramma sp_ms_postlei
   12$_NO_HIGHERTAXON$Agramma sp_ms_tricolor$	Agramma sp_ms_tricolor
   37$_NO_HIGHERTAXON$Agramma vulturnum$	Agramma sp_ms_vulturnum
   36$_NO_HIGHERTAXON$Aitkenia exocarpos$	Aitkenia sp_ms_exocarpos
   32$_NO_HIGHERTAXON$Aitkenia latevagans$	Aitkenia sp_ms_latevagans
    7$_NO_HIGHERTAXON$Aitkenia sp.$	Aitkenia sp.
    1$_NO_HIGHERTAXON$Alcaeus sp_1$	Alcaeus sp_1
    1$_NO_HIGHERTAXON$Alcaeus varicornis$	Alcaeus sp_ms_varicornis
    7$_NO_HIGHERTAXON$Allocader cordatus$	Allocader sp_ms_cordatus
    3$_NO_HIGHERTAXON$Allocader leai$	Allocader sp_ms_leai
    3$_NO_HIGHERTAXON$Allocader nesiotes$	Allocader sp_ms_nesiotes
    1$_NO_HIGHERTAXON$Allocader sp$	Allocader sp
    1$_NO_HIGHERTAXON$Allocader sp_01$	Allocader sp_01
    4$_NO_HIGHERTAXON$Ambunticoris sulawesicus$	Ambunticoris sp_ms_sulawesicus
    9$_NO_HIGHERTAXON$Amphaces sp.$	Amphaces sp.
    4$_NO_HIGHERTAXON$Amphidexius suspensus$	Amphidexius sp_ms_suspensus
   78$_NO_HIGHERTAXON$Ancoraphylus arctous$	Ancoraphylus sp_ms_arctous
   20$_NO_HIGHERTAXON$Ancoraphylus auski$	Ancoraphylus sp_ms_auski
    8$_NO_HIGHERTAXON$Ancoraphylus carolus$	Ancoraphylus sp_ms_carolus
   21$_NO_HIGHERTAXON$Ancoraphylus mariala$	Ancoraphylus sp_ms_mariala
   10$_NO_HIGHERTAXON$Ancoraphylus sp.$	Ancoraphylus sp.
    7$_NO_HIGHERTAXON$Antestiopsis sp_1$	Antestiopsis sp_1
    2$_NO_HIGHERTAXON$Antestiopsis sp_3$	Antestiopsis sp_3
    2$_NO_HIGHERTAXON$Antestiopsis sp_4$	Antestiopsis sp_4
   14$_NO_HIGHERTAXON$Antestiopsis sp_5$	Antestiopsis sp_5
    1$_NO_HIGHERTAXON$Antestiopsis sp_6$	Antestiopsis sp_6
    2$_NO_HIGHERTAXON$Antestiopsis sp_7$	Antestiopsis sp_7
    2$_NO_HIGHERTAXON$Aphrania vishnou$	Aphrania sp_ms_vishnou
   31$_NO_HIGHERTAXON$Aplerotus sp_nr_grossi$	Aplerotus sp_nr_grossi
    1$_NO_HIGHERTAXON$Aradus albicornis$	Aradus sp_ms_albicornis
   13$_NO_HIGHERTAXON$Arafuramiris biakanus$	Arafuramiris sp_ms_biakanus
   20$_NO_HIGHERTAXON$Arafuramiris dreikikir$	Arafuramiris sp_ms_dreikikir
   71$_NO_HIGHERTAXON$Arafuramiris gressitti$	Arafuramiris sp_ms_gressitti
    2$_NO_HIGHERTAXON$Arafuramiris heath$	Arafuramiris sp_ms_heath
    9$_NO_HIGHERTAXON$Arafuramiris jimmi$	Arafuramiris sp_ms_jimmi
    5$_NO_HIGHERTAXON$Arafuramiris oswaldi$	Arafuramiris sp_ms_oswaldi
   28$_NO_HIGHERTAXON$Arafuramiris queenslandensis$	Arafuramiris sp_ms_queenslandensis
   13$_NO_HIGHERTAXON$Arafuramiris sp$	Arafuramiris sp
    1$_NO_HIGHERTAXON$Arcleda fusca$	Arcleda sp_ms_fusca
   21$_NO_HIGHERTAXON$Arniscus humeralis$	Arniscus sp_ms_humeralis
    5$_NO_HIGHERTAXON$Arthriticus eugeniae$	Arthriticus sp_ms_eugeniae
    1$_NO_HIGHERTAXON$Aspideurus sp$	Aspideurus sp
  220$_NO_HIGHERTAXON$Asterophylus chrysocephali$	Asterophylus sp_ms_chrysocephali
  148$_NO_HIGHERTAXON$Asterophylus rutidosis$	Asterophylus sp_ms_rutidosis
    2$_NO_HIGHERTAXON$Atelias variegatus$	Atelias sp_ms_variegatus
   16$_NO_HIGHERTAXON$Au_Phylini_LgP_misc sp.$	Au_Phylini_LgP_misc sp.
   88$_NO_HIGHERTAXON$Au_Phylini_LgP_misc unident.$	Au_Phylini_LgP_misc sp_unident
   65$_NO_HIGHERTAXON$Au_Phylini_nr Atractotomus sp. 10$	Au_Phylini_nr sp_Atractotomus_sp_10
   95$_NO_HIGHERTAXON$Au_Phylini_nr Atractotomus sp.$	Au_Phylini_nr sp_Atractotomus_sp
   31$_NO_HIGHERTAXON$Au_Phylini_nr Atractotomus sp_148$	Au_Phylini_nr Atractotomus sp_148
    1$_NO_HIGHERTAXON$Aulacosternum nigrorubrum$	Aulacosternum sp_ms_nigrorubrum
  872$_NO_HIGHERTAXON$Ausejanus albisignatus$	Ausejanus sp_ms_albisignatus
    8$_NO_HIGHERTAXON$Ausejanus ansevata$	Ausejanus sp_ms_ansevata
   44$_NO_HIGHERTAXON$Ausejanus arvensus$	Ausejanus sp_ms_arvensus
   18$_NO_HIGHERTAXON$Ausejanus bournda$	Ausejanus sp_ms_bournda
   25$_NO_HIGHERTAXON$Ausejanus cordatus$	Ausejanus sp_ms_cordatus
  165$_NO_HIGHERTAXON$Ausejanus femoralis$	Ausejanus sp_ms_femoralis
    7$_NO_HIGHERTAXON$Ausejanus iris$	Ausejanus sp_ms_iris
   47$_NO_HIGHERTAXON$Ausejanus luteoelytratus$	Ausejanus sp_ms_luteoelytratus
    7$_NO_HIGHERTAXON$Ausejanus macrozonata$	Ausejanus sp_ms_macrozonata
  190$_NO_HIGHERTAXON$Ausejanus mcdonaldi$	Ausejanus sp_ms_mcdonaldi
  395$_NO_HIGHERTAXON$Ausejanus meridionalis$	Ausejanus sp_ms_meridionalis
   85$_NO_HIGHERTAXON$Ausejanus minutus$	Ausejanus sp_ms_minutus
  111$_NO_HIGHERTAXON$Ausejanus neboissi$	Ausejanus sp_ms_neboissi
    3$_NO_HIGHERTAXON$Ausejanus png new species$	Ausejanus sp_png_new_species
   10$_NO_HIGHERTAXON$Ausejanus schwartzi$	Ausejanus sp_ms_schwartzi
   51$_NO_HIGHERTAXON$Ausejanus sp$	Ausejanus sp
   77$_NO_HIGHERTAXON$Ausejanus tasmaniae$	Ausejanus sp_ms_tasmaniae
  453$_NO_HIGHERTAXON$Ausejanus tiramisu$	Ausejanus sp_ms_tiramisu
    1$_NO_HIGHERTAXON$Ausejanus uestaustralianus$	Ausejanus sp_ms_uestaustralianus
  268$_NO_HIGHERTAXON$Ausejanus vividus$	Ausejanus sp_ms_vividus
    3$_NO_HIGHERTAXON$Australocader sp.$	Australocader sp.
    1$_NO_HIGHERTAXON$Australotarma sp_nq1$	Australotarma sp_nq1
    3$_NO_HIGHERTAXON$Australotingis franzeni$	Australotingis sp_ms_franzeni
    9$_NO_HIGHERTAXON$Australotingis sp_ms_chillagoe$	Australotingis sp_ms_chillagoe
   30$_NO_HIGHERTAXON$Austrodapus nitens$	Austrodapus sp_ms_nitens
    2$_NO_HIGHERTAXON$Austrodapus nsp queensland$	Austrodapus sp_nsp_queensland
  150$_NO_HIGHERTAXON$Austrokatanga monteithi$	Austrokatanga sp_ms_monteithi
    4$_NO_HIGHERTAXON$Austromiris nigronasutus$	Austromiris sp_ms_nigronasutus
  120$_NO_HIGHERTAXON$Austromiris sp.$	Austromiris sp.
    1$_NO_HIGHERTAXON$Austromiris sp_ms_amiens$	Austromiris sp_ms_amiens
    3$_NO_HIGHERTAXON$Austromiris sp_ms_arida$	Austromiris sp_ms_arida
    1$_NO_HIGHERTAXON$Austromiris sp_ms_boorabinni$	Austromiris sp_ms_boorabinni
    1$_NO_HIGHERTAXON$Austromiris sp_ms_conospermumae$	Austromiris sp_ms_conospermumae
   12$_NO_HIGHERTAXON$Austromiris sp_ms_denticulatus$	Austromiris sp_ms_denticulatus
    6$_NO_HIGHERTAXON$Austromiris sp_ms_diminutus$	Austromiris sp_ms_diminutus
    2$_NO_HIGHERTAXON$Austromiris sp_ms_feehani$	Austromiris sp_ms_feehani
    1$_NO_HIGHERTAXON$Austromiris sp_ms_fuscantennata$	Austromiris sp_ms_fuscantennata
    1$_NO_HIGHERTAXON$Austromiris sp_ms_kalgoorliensis$	Austromiris sp_ms_kalgoorliensis
    2$_NO_HIGHERTAXON$Austromiris sp_ms_luteocuneatus$	Austromiris sp_ms_luteocuneatus
    2$_NO_HIGHERTAXON$Austromiris sp_ms_macmillani$	Austromiris sp_ms_macmillani
    2$_NO_HIGHERTAXON$Austromiris sp_ms_meridionalis$	Austromiris sp_ms_meridionalis
    1$_NO_HIGHERTAXON$Austromiris sp_ms_minutus$	Austromiris sp_ms_minutus
    4$_NO_HIGHERTAXON$Austromiris sp_ms_naumanni$	Austromiris sp_ms_naumanni
    1$_NO_HIGHERTAXON$Austromiris sp_ms_nigracallae$	Austromiris sp_ms_nigracallae
    6$_NO_HIGHERTAXON$Austromiris sp_ms_nooltana$	Austromiris sp_ms_nooltana
    2$_NO_HIGHERTAXON$Austromiris sp_ms_ovatus$	Austromiris sp_ms_ovatus
    2$_NO_HIGHERTAXON$Austromiris sp_ms_roseocuneatus$	Austromiris sp_ms_roseocuneatus
    1$_NO_HIGHERTAXON$Austromiris sp_ms_rubrantennatus$	Austromiris sp_ms_rubrantennatus
   11$_NO_HIGHERTAXON$Austromiris sp_ms_sulinus$	Austromiris sp_ms_sulinus
    1$_NO_HIGHERTAXON$Austromiris sp_ms_uptoni$	Austromiris sp_ms_uptoni
   14$_NO_HIGHERTAXON$Austromiris sp_ms_virescens$	Austromiris sp_ms_virescens
    1$_NO_HIGHERTAXON$Austromiris sp_ms_weiri$	Austromiris sp_ms_weiri
    3$_NO_HIGHERTAXON$Austromiris sp_ms_wirrulla$	Austromiris sp_ms_wirrulla
   13$_NO_HIGHERTAXON$Austromiris sp_s001$	Austromiris sp_s001
   13$_NO_HIGHERTAXON$Austromiris sp_s002$	Austromiris sp_s002
   32$_NO_HIGHERTAXON$Austromiris sp_s003$	Austromiris sp_s003
   16$_NO_HIGHERTAXON$Austromiris sp_s004$	Austromiris sp_s004
   20$_NO_HIGHERTAXON$Austromiris sp_s005$	Austromiris sp_s005
   17$_NO_HIGHERTAXON$Austromiris sp_s006$	Austromiris sp_s006
    5$_NO_HIGHERTAXON$Austromiris sp_s007$	Austromiris sp_s007
    7$_NO_HIGHERTAXON$Austromiris sp_s008$	Austromiris sp_s008
   31$_NO_HIGHERTAXON$Austromiris sp_s009$	Austromiris sp_s009
    5$_NO_HIGHERTAXON$Austromiris sp_s010$	Austromiris sp_s010
   13$_NO_HIGHERTAXON$Austromiris sp_s011$	Austromiris sp_s011
    3$_NO_HIGHERTAXON$Austromiris sp_s012$	Austromiris sp_s012
   26$_NO_HIGHERTAXON$Austromiris sp_s013$	Austromiris sp_s013
    7$_NO_HIGHERTAXON$Austromiris sp_s014$	Austromiris sp_s014
    8$_NO_HIGHERTAXON$Austromiris sp_s015$	Austromiris sp_s015
    2$_NO_HIGHERTAXON$Austromiris sp_s017$	Austromiris sp_s017
   10$_NO_HIGHERTAXON$Austromiris sp_s018$	Austromiris sp_s018
    7$_NO_HIGHERTAXON$Austromiris sp_s019$	Austromiris sp_s019
    8$_NO_HIGHERTAXON$Austromiris sp_s020$	Austromiris sp_s020
    2$_NO_HIGHERTAXON$Austromiris sp_s021$	Austromiris sp_s021
    8$_NO_HIGHERTAXON$Austromiris sp_s022$	Austromiris sp_s022
    3$_NO_HIGHERTAXON$Austromiris sp_s023$	Austromiris sp_s023
    2$_NO_HIGHERTAXON$Austromiris sp_s024$	Austromiris sp_s024
    3$_NO_HIGHERTAXON$Austromiris sp_s025$	Austromiris sp_s025
    2$_NO_HIGHERTAXON$Austromiris sp_s027$	Austromiris sp_s027
   40$_NO_HIGHERTAXON$Austromiris sp_s028$	Austromiris sp_s028
    7$_NO_HIGHERTAXON$Austromiris sp_s029$	Austromiris sp_s029
    2$_NO_HIGHERTAXON$Austromiris sp_s030$	Austromiris sp_s030
    2$_NO_HIGHERTAXON$Austromiris sp_s031$	Austromiris sp_s031
    4$_NO_HIGHERTAXON$Austromiris sp_s032$	Austromiris sp_s032
    3$_NO_HIGHERTAXON$Austromiris sp_s033$	Austromiris sp_s033
    4$_NO_HIGHERTAXON$Austromiris sp_s034$	Austromiris sp_s034
    2$_NO_HIGHERTAXON$Austromiris sp_s037$	Austromiris sp_s037
    2$_NO_HIGHERTAXON$Austromiris sp_s038$	Austromiris sp_s038
    3$_NO_HIGHERTAXON$Austromiris sp_s039$	Austromiris sp_s039
    3$_NO_HIGHERTAXON$Austromiris sp_s042$	Austromiris sp_s042
    2$_NO_HIGHERTAXON$Austromiris sp_s044$	Austromiris sp_s044
    5$_NO_HIGHERTAXON$Austromiris viridissimus$	Austromiris sp_ms_viridissimus
    1$_NO_HIGHERTAXON$Austroplagiognathus arbustoides$	Austroplagiognathus sp_ms_arbustoides
    1$_NO_HIGHERTAXON$Austroplagiognathus parallelus$	Austroplagiognathus sp_ms_parallelus
    2$_NO_HIGHERTAXON$Avicenna aggressor$	Avicenna sp_ms_aggressor
    1$_NO_HIGHERTAXON$Avicenna auricornis$	Avicenna sp_ms_auricornis
    3$_NO_HIGHERTAXON$Avicenna inquinata$	Avicenna sp_ms_inquinata
    1$_NO_HIGHERTAXON$Avicenna sp_1$	Avicenna sp_1
    4$_NO_HIGHERTAXON$Avicenna sp_2$	Avicenna sp_2
    1$_NO_HIGHERTAXON$Baclozygum bergrothi$	Baclozygum sp_ms_bergrothi
    1$_NO_HIGHERTAXON$Baclozygum brachypterum$	Baclozygum sp_ms_brachypterum
    2$_NO_HIGHERTAXON$Baclozygum depressum$	Baclozygum sp_ms_depressum
    2$_NO_HIGHERTAXON$Baclozygum pr. brachypterum$	Baclozygum sp_pr_brachypterum
    1$_NO_HIGHERTAXON$Baclozygum sp.$	Baclozygum sp.
   13$_NO_HIGHERTAXON$Belenus sp_01$	Belenus sp_01
   21$_NO_HIGHERTAXON$Belenus sp_02$	Belenus sp_02
   33$_NO_HIGHERTAXON$Bifidostylus agnew$	Bifidostylus sp_ms_agnew
  182$_NO_HIGHERTAXON$Bifidostylus cassisi$	Bifidostylus sp_ms_cassisi
    1$_NO_HIGHERTAXON$Bifidostylus finalis$	Bifidostylus sp_ms_finalis
    2$_NO_HIGHERTAXON$Bifidostylus gawlerensis$	Bifidostylus sp_ms_gawlerensis
   78$_NO_HIGHERTAXON$Bifidostylus gilesi$	Bifidostylus sp_ms_gilesi
   11$_NO_HIGHERTAXON$Bifidostylus kalgoorlie$	Bifidostylus sp_ms_kalgoorlie
   10$_NO_HIGHERTAXON$Bifidostylus newmanensis$	Bifidostylus sp_ms_newmanensis
  114$_NO_HIGHERTAXON$Bifidostylus occidentalis$	Bifidostylus sp_ms_occidentalis
  647$_NO_HIGHERTAXON$Bifidostylus omnivorus$	Bifidostylus sp_ms_omnivorus
  360$_NO_HIGHERTAXON$Bifidostylus silverae$	Bifidostylus sp_ms_silverae
    1$_NO_HIGHERTAXON$Biromiris binjour$	Biromiris sp_ms_binjour
   13$_NO_HIGHERTAXON$Biromiris bulolo$	Biromiris sp_ms_bulolo
    1$_NO_HIGHERTAXON$Biromiris cassisi$	Biromiris sp_ms_cassisi
    1$_NO_HIGHERTAXON$Biromiris cyclops$	Biromiris sp_ms_cyclops
    3$_NO_HIGHERTAXON$Biromiris enarotadi$	Biromiris sp_ms_enarotadi
    2$_NO_HIGHERTAXON$Biromiris scheyville$	Biromiris sp_ms_scheyville
    9$_NO_HIGHERTAXON$Biromiris sp.$	Biromiris sp.
   13$_NO_HIGHERTAXON$Bironiella sp.$	Bironiella sp.
   84$_NO_HIGHERTAXON$Blesingia fasciatipennis$	Blesingia sp_ms_fasciatipennis
    4$_NO_HIGHERTAXON$Blesingia grandis$	Blesingia sp_ms_grandis
   60$_NO_HIGHERTAXON$Blesingia gularis$	Blesingia sp_ms_gularis
    2$_NO_HIGHERTAXON$Blesingia mamai$	Blesingia sp_ms_mamai
    1$_NO_HIGHERTAXON$Blesingia promeceops$	Blesingia sp_ms_promeceops
    2$_NO_HIGHERTAXON$Blesingia sp.$	Blesingia sp.
    1$_NO_HIGHERTAXON$Blesingia tamborinea$	Blesingia sp_ms_tamborinea
    2$_NO_HIGHERTAXON$Bothriomiris sp.$	Bothriomiris sp.
    2$_NO_HIGHERTAXON$Bromocoris souefi$	Bromocoris sp_ms_souefi
    5$_NO_HIGHERTAXON$Bunotingis camelina$	Bunotingis sp_ms_camelina
    1$_NO_HIGHERTAXON$Bunotingis sp.$	Bunotingis sp.
    1$_NO_HIGHERTAXON$Cacodmus bambusicola$	Cacodmus sp_ms_bambusicola
    3$_NO_HIGHERTAXON$Cacodmus sumatrensis$	Cacodmus sp_ms_sumatrensis
    1$_NO_HIGHERTAXON$Callicorixa vulnerata$	Callicorixa sp_ms_vulnerata
    1$_NO_HIGHERTAXON$Callithrincus serratus$	Callithrincus sp_ms_serratus
    1$_NO_HIGHERTAXON$Callithrincus signatus$	Callithrincus sp_ms_signatus
    3$_NO_HIGHERTAXON$Caloloma sp_01$	Caloloma sp_01
   84$_NO_HIGHERTAXON$Caloloma sp_02$	Caloloma sp_02
    4$_NO_HIGHERTAXON$Caloloma sp_03$	Caloloma sp_03
   29$_NO_HIGHERTAXON$Caloloma sp_04$	Caloloma sp_04
    5$_NO_HIGHERTAXON$Caloloma sp_ms_murray sunset$	Caloloma sp_ms_murray_sunset
   10$_NO_HIGHERTAXON$Caloloma sp_ms_norseman$	Caloloma sp_ms_norseman
    6$_NO_HIGHERTAXON$Caloloma uhleri$	Caloloma sp_ms_uhleri
    2$_NO_HIGHERTAXON$Calotingis subopaca$	Calotingis sp_ms_subopaca
    2$_NO_HIGHERTAXON$Campylomma atra$	Campylomma sp_ms_atra
    1$_NO_HIGHERTAXON$Campylomma austrina$	Campylomma sp_ms_austrina
    2$_NO_HIGHERTAXON$Campylomma irianica$	Campylomma sp_ms_irianica
  133$_NO_HIGHERTAXON$Campylomma liebknechti$	Campylomma sp_ms_liebknechti
    2$_NO_HIGHERTAXON$Campylomma lividicornis$	Campylomma sp_ms_lividicornis
    6$_NO_HIGHERTAXON$Campylomma marjorae$	Campylomma sp_ms_marjorae
    1$_NO_HIGHERTAXON$Campylomma marmorosa$	Campylomma sp_ms_marmorosa
    1$_NO_HIGHERTAXON$Campylomma nigra$	Campylomma sp_ms_nigra
    2$_NO_HIGHERTAXON$Campylomma noumeae$	Campylomma sp_ms_noumeae
    2$_NO_HIGHERTAXON$Campylomma novocaledonica$	Campylomma sp_ms_novocaledonica
    1$_NO_HIGHERTAXON$Campylomma pacificae$	Campylomma sp_ms_pacificae
    2$_NO_HIGHERTAXON$Campylomma papuana$	Campylomma sp_ms_papuana
    2$_NO_HIGHERTAXON$Campylomma sandaracine$	Campylomma sp_ms_sandaracine
   14$_NO_HIGHERTAXON$Campylomma seminigricaput$	Campylomma sp_ms_seminigricaput
    3$_NO_HIGHERTAXON$Campylomma sp$	Campylomma sp
    1$_NO_HIGHERTAXON$Campyloneuropsis sp.$	Campyloneuropsis sp.
    8$_NO_HIGHERTAXON$Candidomiris albomaculatus$	Candidomiris sp_ms_albomaculatus
    3$_NO_HIGHERTAXON$Candidomiris ms_realk02$	Candidomiris sp_ms_realk02
   17$_NO_HIGHERTAXON$Candidomiris sp_k01$	Candidomiris sp_k01
   30$_NO_HIGHERTAXON$Candidomiris sp_k02$	Candidomiris sp_k02
    7$_NO_HIGHERTAXON$Candidomiris sp_k06$	Candidomiris sp_k06
    2$_NO_HIGHERTAXON$Candidomiris sp_k07a$	Candidomiris sp_k07a
    1$_NO_HIGHERTAXON$Candidomiris sp_k19$	Candidomiris sp_k19
    3$_NO_HIGHERTAXON$Candidomiris sp_k21$	Candidomiris sp_k21
    4$_NO_HIGHERTAXON$Candidomiris sp_k22$	Candidomiris sp_k22
   39$_NO_HIGHERTAXON$Candidomiris sp_knc02$	Candidomiris sp_knc02
   14$_NO_HIGHERTAXON$Candidomiris sp_ms_monteithi$	Candidomiris sp_ms_monteithi
    8$_NO_HIGHERTAXON$Candidomiris sp_ms_tatarnici$	Candidomiris sp_ms_tatarnici
    7$_NO_HIGHERTAXON$Cantacader nocturnis$	Cantacader sp_ms_nocturnis
    8$_NO_HIGHERTAXON$Cantacader sp$	Cantacader sp
   17$_NO_HIGHERTAXON$Cantacader sp_01$	Cantacader sp_01
    2$_NO_HIGHERTAXON$Cantacader sp_02$	Cantacader sp_02
    2$_NO_HIGHERTAXON$Cantacader sp_03$	Cantacader sp_03
    1$_NO_HIGHERTAXON$Carayonia australiensis$	Carayonia sp_ms_australiensis
    3$_NO_HIGHERTAXON$Carldrakeana socia$	Carldrakeana sp_ms_socia
   26$_NO_HIGHERTAXON$Carldrakeana sp$	Carldrakeana sp
   14$_NO_HIGHERTAXON$Carldrakeana sp_01$	Carldrakeana sp_01
    1$_NO_HIGHERTAXON$Carldrakeana sp_02$	Carldrakeana sp_02
    1$_NO_HIGHERTAXON$Carldrakeana sp_03$	Carldrakeana sp_03
   16$_NO_HIGHERTAXON$Carldrakeana tindalei$	Carldrakeana sp_ms_tindalei
    5$_NO_HIGHERTAXON$Carvalhoma sp_ms_parva$	Carvalhoma sp_ms_parva
    5$_NO_HIGHERTAXON$Celantia sp.$	Celantia sp.
    1$_NO_HIGHERTAXON$Cephaloplatus bellus$	Cephaloplatus sp_ms_bellus
    3$_NO_HIGHERTAXON$Cephaloplatus sp_1$	Cephaloplatus sp_1
    7$_NO_HIGHERTAXON$Ceratocader armatus$	Ceratocader sp_ms_armatus
    2$_NO_HIGHERTAXON$Ceratocader dentatus$	Ceratocader sp_ms_dentatus
    7$_NO_HIGHERTAXON$Ceratocader sp_01$	Ceratocader sp_01
    1$_NO_HIGHERTAXON$Ceratocader sp_02$	Ceratocader sp_02
    2$_NO_HIGHERTAXON$Ceratocader sp_03$	Ceratocader sp_03
    2$_NO_HIGHERTAXON$Ceratocader sp_04$	Ceratocader sp_04
    1$_NO_HIGHERTAXON$Ceratocader sp_05$	Ceratocader sp_05
   17$_NO_HIGHERTAXON$Cermatulus nasalis$	Cermatulus sp_ms_nasalis
   41$_NO_HIGHERTAXON$Chimsunchartella schwartzi$	Chimsunchartella sp_ms_schwartzi
    3$_NO_HIGHERTAXON$Chorotingis indigena$	Chorotingis sp_ms_indigena
   53$_NO_HIGHERTAXON$Chorotingis sp_01$	Chorotingis sp_01
    6$_NO_HIGHERTAXON$Chorotingis sp_02$	Chorotingis sp_02
    5$_NO_HIGHERTAXON$Cimex hemipterus$	Cimex sp_ms_hemipterus
   11$_NO_HIGHERTAXON$Cimex lectularius$	Cimex sp_ms_lectularius
    3$_NO_HIGHERTAXON$Cleotomiris schneirlai$	Cleotomiris sp_ms_schneirlai
   16$_NO_HIGHERTAXON$Codotingis evansi$	Codotingis sp_ms_evansi
    2$_NO_HIGHERTAXON$Codotingis sp_01_poss_recurva$	Codotingis sp_01_poss_recurva
    1$_NO_HIGHERTAXON$Codotingis sp_02$	Codotingis sp_02
    1$_NO_HIGHERTAXON$Codotingis sp_03$	Codotingis sp_03
    2$_NO_HIGHERTAXON$Codotingis sp_ms_tambourine$	Codotingis sp_ms_tambourine
   31$_NO_HIGHERTAXON$Collessicoris bellissimus$	Collessicoris sp_ms_bellissimus
    1$_NO_HIGHERTAXON$Collessicoris sp.$	Collessicoris sp.
    8$_NO_HIGHERTAXON$Compseuta lefroyi$	Compseuta sp_ms_lefroyi
    7$_NO_HIGHERTAXON$Cooperocoris australis$	Cooperocoris sp_ms_australis
    1$_NO_HIGHERTAXON$Coridromius basilanus$	Coridromius sp_ms_basilanus
   14$_NO_HIGHERTAXON$Coridromius bicolor$	Coridromius sp_ms_bicolor
   17$_NO_HIGHERTAXON$Coridromius boianotum$	Coridromius sp_ms_boianotum
    1$_NO_HIGHERTAXON$Coridromius carinatus$	Coridromius sp_ms_carinatus
 1465$_NO_HIGHERTAXON$Coridromius chenopoderis$	Coridromius sp_ms_chenopoderis
    3$_NO_HIGHERTAXON$Coridromius chinensis$	Coridromius sp_ms_chinensis
  108$_NO_HIGHERTAXON$Coridromius confusus$	Coridromius sp_ms_confusus
    7$_NO_HIGHERTAXON$Coridromius crassus$	Coridromius sp_ms_crassus
    1$_NO_HIGHERTAXON$Coridromius drepanopenis$	Coridromius sp_ms_drepanopenis
    1$_NO_HIGHERTAXON$Coridromius epithema$	Coridromius sp_ms_epithema
    1$_NO_HIGHERTAXON$Coridromius eremnos$	Coridromius sp_ms_eremnos
    4$_NO_HIGHERTAXON$Coridromius falsicoleus$	Coridromius sp_ms_falsicoleus
   10$_NO_HIGHERTAXON$Coridromius hermosus$	Coridromius sp_ms_hermosus
    4$_NO_HIGHERTAXON$Coridromius marmoreus$	Coridromius sp_ms_marmoreus
    2$_NO_HIGHERTAXON$Coridromius minusculus$	Coridromius sp_ms_minusculus
  428$_NO_HIGHERTAXON$Coridromius monotocopsis$	Coridromius sp_ms_monotocopsis
    9$_NO_HIGHERTAXON$Coridromius neoguineanus$	Coridromius sp_ms_neoguineanus
    1$_NO_HIGHERTAXON$Coridromius nigrus$	Coridromius sp_ms_nigrus
   17$_NO_HIGHERTAXON$Coridromius norfolkensis$	Coridromius sp_ms_norfolkensis
  162$_NO_HIGHERTAXON$Coridromius pilbarensis$	Coridromius sp_ms_pilbarensis
    1$_NO_HIGHERTAXON$Coridromius prolixipenis$	Coridromius sp_ms_prolixipenis
   13$_NO_HIGHERTAXON$Coridromius pteraulos$	Coridromius sp_ms_pteraulos
   14$_NO_HIGHERTAXON$Coridromius punctatus$	Coridromius sp_ms_punctatus
    6$_NO_HIGHERTAXON$Coridromius sommelieri$	Coridromius sp_ms_sommelieri
    1$_NO_HIGHERTAXON$Coridromius sp$	Coridromius sp
    1$_NO_HIGHERTAXON$Coridromius testaceus$	Coridromius sp_ms_testaceus
    1$_NO_HIGHERTAXON$Coridromius thalame$	Coridromius sp_ms_thalame
  107$_NO_HIGHERTAXON$Coridromius variegatus$	Coridromius sp_ms_variegatus
    1$_NO_HIGHERTAXON$Cornaus callosus$	Cornaus sp_ms_callosus
    5$_NO_HIGHERTAXON$Cottothucha oceanae$	Cottothucha sp_ms_oceanae
    2$_NO_HIGHERTAXON$Cottothucha sp$	Cottothucha sp
    5$_NO_HIGHERTAXON$Cottothucha sp_ms_kalathis$	Cottothucha sp_ms_kalathis
    6$_NO_HIGHERTAXON$Cranberrus MS baccus$	Cranberrus sp_MS_baccus
   34$_NO_HIGHERTAXON$Creontiades dilutus$	Creontiades sp_ms_dilutus
    3$_NO_HIGHERTAXON$Creontiades sp.$	Creontiades sp.
    1$_NO_HIGHERTAXON$Cromerus hackeri$	Cromerus sp_ms_hackeri
    8$_NO_HIGHERTAXON$Cromerus sp_01$	Cromerus sp_01
    2$_NO_HIGHERTAXON$Cryptocoris fasciatus$	Cryptocoris sp_ms_fasciatus
    3$_NO_HIGHERTAXON$Ctypomiris brendae$	Ctypomiris sp_ms_brendae
    6$_NO_HIGHERTAXON$Ctypomiris kokure$	Ctypomiris sp_ms_kokure
    2$_NO_HIGHERTAXON$Ctypomiris solomonensis$	Ctypomiris sp_ms_solomonensis
   13$_NO_HIGHERTAXON$Cuspicona sp_1$	Cuspicona sp_1
    6$_NO_HIGHERTAXON$Cuspicona sp_2$	Cuspicona sp_2
    1$_NO_HIGHERTAXON$Cymodema basicornis$	Cymodema sp_ms_basicornis
    1$_NO_HIGHERTAXON$Cymus sp$	Cymus sp
    1$_NO_HIGHERTAXON$Cymus sp_2$	Cymus sp_2
    1$_NO_HIGHERTAXON$Cyperobia sp$	Cyperobia sp
  103$_NO_HIGHERTAXON$Cyrtorhinus carvalhoi$	Cyrtorhinus sp_ms_carvalhoi
    4$_NO_HIGHERTAXON$Cyrtorhinus cumberi$	Cyrtorhinus sp_ms_cumberi
   32$_NO_HIGHERTAXON$Cyrtorhinus defectus$	Cyrtorhinus sp_ms_defectus
    3$_NO_HIGHERTAXON$Cyrtorhinus eylesi$	Cyrtorhinus sp_ms_eylesi
   15$_NO_HIGHERTAXON$Cyrtorhinus fulvus$	Cyrtorhinus sp_ms_fulvus
  232$_NO_HIGHERTAXON$Cyrtorhinus lividipennis$	Cyrtorhinus sp_ms_lividipennis
    6$_NO_HIGHERTAXON$Cyrtorhinus ms_palauensis$	Cyrtorhinus sp_ms_palauensis
    5$_NO_HIGHERTAXON$Cyrtorhinus ms_rarus$	Cyrtorhinus sp_ms_rarus
   36$_NO_HIGHERTAXON$Cyrtorhinus sp_3_malaya$	Cyrtorhinus sp_3_malaya
   56$_NO_HIGHERTAXON$Cyrtorhinus sp_3_nr_lividipennis$	Cyrtorhinus sp_3_nr_lividipennis
   11$_NO_HIGHERTAXON$Cyrtorhinus sp_5m$	Cyrtorhinus sp_5m
   64$_NO_HIGHERTAXON$Cyrtorhinus sp_nr_carvalhoi_nb$	Cyrtorhinus sp_nr_carvalhoi_nb
   36$_NO_HIGHERTAXON$Cyrtorhinus sp_nr_fulvus_philippines$	Cyrtorhinus sp_nr_fulvus_philippines
    2$_NO_HIGHERTAXON$Cyrtorhinus sp_nr_lividipennis_luzon$	Cyrtorhinus sp_nr_lividipennis_luzon
    8$_NO_HIGHERTAXON$Cyrtorhinus sp_nr_lividipennis_subc$	Cyrtorhinus sp_nr_lividipennis_subc
    1$_NO_HIGHERTAXON$Cyrtorhinus vitiensis$	Cyrtorhinus sp_ms_vitiensis
    1$_NO_HIGHERTAXON$Cysteochila aletheia$	Cysteochila sp_ms_aletheia
    1$_NO_HIGHERTAXON$Cysteochila brunnea$	Cysteochila sp_ms_brunnea
    5$_NO_HIGHERTAXON$Cysteochila sp_01$	Cysteochila sp_01
    1$_NO_HIGHERTAXON$Cysteochila sp_03$	Cysteochila sp_03
    2$_NO_HIGHERTAXON$Cysteochila sp_04$	Cysteochila sp_04
    1$_NO_HIGHERTAXON$Cysteochila sp_05$	Cysteochila sp_05
    3$_NO_HIGHERTAXON$Cysteochila sp_06$	Cysteochila sp_06
    2$_NO_HIGHERTAXON$Cysteochila sp_07$	Cysteochila sp_07
    1$_NO_HIGHERTAXON$Cysteochila sp_nr_idonea$	Cysteochila sp_nr_idonea
   31$_NO_HIGHERTAXON$Daerlac apicalis$	Daerlac sp_ms_apicalis
   78$_NO_HIGHERTAXON$Daerlac cephalotes$	Daerlac sp_ms_cephalotes
   52$_NO_HIGHERTAXON$Daerlac nigricans$	Daerlac sp_ms_nigricans
   11$_NO_HIGHERTAXON$Daerlac picturatus$	Daerlac sp_ms_picturatus
   91$_NO_HIGHERTAXON$Dampierella schwartzi$	Dampierella sp_ms_schwartzi
    2$_NO_HIGHERTAXON$Dasymiris schoutedeni$	Dasymiris sp_ms_schoutedeni
   20$_NO_HIGHERTAXON$Dasymiris sp.$	Dasymiris sp.
    1$_NO_HIGHERTAXON$Decomia appendix$	Decomia sp_ms_appendix
   11$_NO_HIGHERTAXON$Decomia microgonoporos$	Decomia sp_ms_microgonoporos
   40$_NO_HIGHERTAXON$Decomia notata$	Decomia sp_ms_notata
    2$_NO_HIGHERTAXON$Decomia papuensis$	Decomia sp_ms_papuensis
    1$_NO_HIGHERTAXON$Decomia pendleburyi$	Decomia sp_ms_pendleburyi
    2$_NO_HIGHERTAXON$Decomia perparvula$	Decomia sp_ms_perparvula
    1$_NO_HIGHERTAXON$Decomioides bacchusi$	Decomioides sp_ms_bacchusi
    2$_NO_HIGHERTAXON$Decomioides innotata$	Decomioides sp_ms_innotata
    1$_NO_HIGHERTAXON$Decomioides philippinensis$	Decomioides sp_ms_philippinensis
    3$_NO_HIGHERTAXON$Decomioides schneirlai$	Decomioides sp_ms_schneirlai
    2$_NO_HIGHERTAXON$Deraeocoris australicus$	Deraeocoris sp_ms_australicus
    4$_NO_HIGHERTAXON$Deraeocoris signatus$	Deraeocoris sp_ms_signatus
   21$_NO_HIGHERTAXON$Deraeocoris sp.$	Deraeocoris sp.
   34$_NO_HIGHERTAXON$Deraeocoris sp_ms_gillespieae$	Deraeocoris sp_ms_gillespieae
   12$_NO_HIGHERTAXON$Deraeocoris stilipsis$	Deraeocoris sp_ms_stilipsis
    1$_NO_HIGHERTAXON$Dicranocephalus aroonanus$	Dicranocephalus sp_ms_aroonanus
    5$_NO_HIGHERTAXON$Dictyla aima$	Dictyla sp_ms_aima
   47$_NO_HIGHERTAXON$Dictyla amitina$	Dictyla sp_ms_amitina
    1$_NO_HIGHERTAXON$Dictyla sp_01$	Dictyla sp_01
    1$_NO_HIGHERTAXON$Dictyla sp_02$	Dictyla sp_02
    2$_NO_HIGHERTAXON$Dictyla sp_03$	Dictyla sp_03
    1$_NO_HIGHERTAXON$Dictyla sp_04$	Dictyla sp_04
    2$_NO_HIGHERTAXON$Dictyla sp_05$	Dictyla sp_05
    1$_NO_HIGHERTAXON$Dictyla sp_06$	Dictyla sp_06
   83$_NO_HIGHERTAXON$Dictyla sp_nsp_forty_mile_scrub$	Dictyla sp_nsp_forty_mile_scrub
   28$_NO_HIGHERTAXON$Dictyotus caenosus$	Dictyotus sp_ms_caenosus
   24$_NO_HIGHERTAXON$Dictyotus inconspicuus$	Dictyotus sp_ms_inconspicuus
    1$_NO_HIGHERTAXON$Dicyphus hyalinipennis$	Dicyphus sp_ms_hyalinipennis
   13$_NO_HIGHERTAXON$Dicyphylus beaglensis$	Dicyphylus sp_ms_beaglensis
   67$_NO_HIGHERTAXON$Dicyphylus brachyscome$	Dicyphylus sp_ms_brachyscome
  107$_NO_HIGHERTAXON$Dicyphylus halganii$	Dicyphylus sp_ms_halganii
  148$_NO_HIGHERTAXON$Dicyphylus pilbara$	Dicyphylus sp_ms_pilbara
   58$_NO_HIGHERTAXON$Dicyphylus scaevolae$	Dicyphylus sp_ms_scaevolae
   18$_NO_HIGHERTAXON$Dicyphylus solani$	Dicyphylus sp_ms_solani
    1$_NO_HIGHERTAXON$Dieuches sp.$	Dieuches sp.
   19$_NO_HIGHERTAXON$Dilatops fici$	Dilatops sp_ms_fici
    1$_NO_HIGHERTAXON$Dilompus robustus$	Dilompus sp_ms_robustus
    2$_NO_HIGHERTAXON$Dimifacoris fasciatus$	Dimifacoris sp_ms_fasciatus
   17$_NO_HIGHERTAXON$Dimifacoris ma_trifurcata$	Dimifacoris sp_ma_trifurcata
    4$_NO_HIGHERTAXON$Dimifacoris ms_bifurcata$	Dimifacoris sp_ms_bifurcata
   11$_NO_HIGHERTAXON$Dimifacoris ms_splendida$	Dimifacoris sp_ms_splendida
   16$_NO_HIGHERTAXON$Dimifacoris sp_k03$	Dimifacoris sp_k03
   10$_NO_HIGHERTAXON$Dimifacoris sp_np7$	Dimifacoris sp_np7
    4$_NO_HIGHERTAXON$Diocleroides sulawesi$	Diocleroides sp_ms_sulawesi
    2$_NO_HIGHERTAXON$Dioclerus malayensis$	Dioclerus sp_ms_malayensis
  192$_NO_HIGHERTAXON$Diomocoris sp.$	Diomocoris sp.
  309$_NO_HIGHERTAXON$Diomocoris sp_ms_nebulosus$	Diomocoris sp_ms_nebulosus
  112$_NO_HIGHERTAXON$Diplazicoris lombokianus$	Diplazicoris sp_ms_lombokianus
  140$_NO_HIGHERTAXON$Diplocysta bilobata$	Diplocysta sp_ms_bilobata
    6$_NO_HIGHERTAXON$Diplocysta globuliformis$	Diplocysta sp_ms_globuliformis
    8$_NO_HIGHERTAXON$Diplocysta sp.$	Diplocysta sp.
  222$_NO_HIGHERTAXON$Diplocysta trilobata$	Diplocysta sp_ms_trilobata
    8$_NO_HIGHERTAXON$Dippilana membranacea$	Dippilana sp_ms_membranacea
    1$_NO_HIGHERTAXON$Dolichomiris linearis$	Dolichomiris sp_ms_linearis
    1$_NO_HIGHERTAXON$Dysaphis &#40;Dysaphis&#41; apiifolia$	Dysaphis sp_Dysaphis_apiifolia
    1$_NO_HIGHERTAXON$Ectomocoris ornatus$	Ectomocoris sp_ms_ornatus
    1$_NO_HIGHERTAXON$Ectrychotes serdangensis$	Ectrychotes sp_ms_serdangensis
    1$_NO_HIGHERTAXON$Ectrychotes sp_2$	Ectrychotes sp_2
    1$_NO_HIGHERTAXON$Edessa spp.$	Edessa spp.
    3$_NO_HIGHERTAXON$Emesopsis cirratus$	Emesopsis sp_ms_cirratus
    1$_NO_HIGHERTAXON$Empicoris sp_2$	Empicoris sp_2
    5$_NO_HIGHERTAXON$Engynoma immaculata$	Engynoma sp_ms_immaculata
    1$_NO_HIGHERTAXON$Engynoma isolata$	Engynoma sp_ms_isolata
    1$_NO_HIGHERTAXON$Engynoma sp_02$	Engynoma sp_02
    1$_NO_HIGHERTAXON$Engynoma sp_03$	Engynoma sp_03
   22$_NO_HIGHERTAXON$Engynoma sp_04$	Engynoma sp_04
    1$_NO_HIGHERTAXON$Engynoma spinicollis$	Engynoma sp_ms_spinicollis
    7$_NO_HIGHERTAXON$Engytatus nicotianae$	Engytatus sp_ms_nicotianae
   25$_NO_HIGHERTAXON$Epimixia alitophrosyne$	Epimixia sp_ms_alitophrosyne
   25$_NO_HIGHERTAXON$Epimixia nigriceps$	Epimixia sp_ms_nigriceps
  211$_NO_HIGHERTAXON$Epimixia nigripes ssp. dysmica$	Epimixia sp_nigripes_ssp_dysmica
    1$_NO_HIGHERTAXON$Epimixia nigripes ssp. nigripes$	Epimixia sp_nigripes_ssp_nigripes
   14$_NO_HIGHERTAXON$Epimixia sp$	Epimixia sp
  414$_NO_HIGHERTAXON$Epimixia sp_ms_aboccidente$	Epimixia sp_ms_aboccidente
    4$_NO_HIGHERTAXON$Epimixia sp_ms_acclivis$	Epimixia sp_ms_acclivis
   32$_NO_HIGHERTAXON$Epimixia sp_ms_allocasuarina$	Epimixia sp_ms_allocasuarina
    1$_NO_HIGHERTAXON$Epimixia sp_ms_bicolor$	Epimixia sp_ms_bicolor
    8$_NO_HIGHERTAXON$Epimixia sp_ms_caerulamons$	Epimixia sp_ms_caerulamons
    8$_NO_HIGHERTAXON$Epimixia sp_ms_christopherdarwini$	Epimixia sp_ms_christopherdarwini
   67$_NO_HIGHERTAXON$Epimixia sp_ms_eneabba$	Epimixia sp_ms_eneabba
    3$_NO_HIGHERTAXON$Epimixia sp_ms_fulva$	Epimixia sp_ms_fulva
    1$_NO_HIGHERTAXON$Epimixia sp_ms_gagne$	Epimixia sp_ms_gagne
    4$_NO_HIGHERTAXON$Epimixia sp_ms_leai$	Epimixia sp_ms_leai
    1$_NO_HIGHERTAXON$Epimixia sp_ms_megacosta$	Epimixia sp_ms_megacosta
    5$_NO_HIGHERTAXON$Epimixia sp_ms_minor$	Epimixia sp_ms_minor
    6$_NO_HIGHERTAXON$Epimixia sp_ms_schuhi$	Epimixia sp_ms_schuhi
   71$_NO_HIGHERTAXON$Epimixia sp_ms_tropica$	Epimixia sp_ms_tropica
   19$_NO_HIGHERTAXON$Epimixia sp_pbi_wa04$	Epimixia sp_pbi_wa04
  239$_NO_HIGHERTAXON$Epimixia veteris$	Epimixia sp_ms_veteris
   33$_NO_HIGHERTAXON$Epimixia vittata$	Epimixia sp_ms_vittata
  304$_NO_HIGHERTAXON$Epimixia vulturna$	Epimixia sp_ms_vulturna
   22$_NO_HIGHERTAXON$Eremotylus betoota$	Eremotylus sp_ms_betoota
    5$_NO_HIGHERTAXON$Eremotylus glaber$	Eremotylus sp_ms_glaber
    5$_NO_HIGHERTAXON$Eremotylus hibbertii$	Eremotylus sp_ms_hibbertii
   75$_NO_HIGHERTAXON$Eremotylus mosmanensis$	Eremotylus sp_ms_mosmanensis
   30$_NO_HIGHERTAXON$Eremotylus stuarti$	Eremotylus sp_ms_stuarti
   17$_NO_HIGHERTAXON$Eritingis agyiates$	Eritingis sp_ms_agyiates
    1$_NO_HIGHERTAXON$Eritingis amoena$	Eritingis sp_ms_amoena
  187$_NO_HIGHERTAXON$Eritingis aporema$	Eritingis sp_ms_aporema
    2$_NO_HIGHERTAXON$Eritingis exalla$	Eritingis sp_ms_exalla
    2$_NO_HIGHERTAXON$Eritingis hylaea$	Eritingis sp_ms_hylaea
  527$_NO_HIGHERTAXON$Eritingis koebeli$	Eritingis sp_ms_koebeli
   21$_NO_HIGHERTAXON$Eritingis sp$	Eritingis sp
  128$_NO_HIGHERTAXON$Eritingis sp_01$	Eritingis sp_01
  122$_NO_HIGHERTAXON$Eritingis sp_02$	Eritingis sp_02
  174$_NO_HIGHERTAXON$Eritingis sp_03_poss_aporema$	Eritingis sp_03_poss_aporema
    9$_NO_HIGHERTAXON$Eritingis sp_05$	Eritingis sp_05
    6$_NO_HIGHERTAXON$Eritingis sp_06$	Eritingis sp_06
    2$_NO_HIGHERTAXON$Eritingis sp_07$	Eritingis sp_07
    9$_NO_HIGHERTAXON$Eritingis sp_08$	Eritingis sp_08
   34$_NO_HIGHERTAXON$Eritingis sp_09$	Eritingis sp_09
    6$_NO_HIGHERTAXON$Eritingis sp_10$	Eritingis sp_10
    2$_NO_HIGHERTAXON$Eritingis sp_ms_almaden$	Eritingis sp_ms_almaden
    5$_NO_HIGHERTAXON$Eritingis sp_ms_chillagoe$	Eritingis sp_ms_chillagoe
    1$_NO_HIGHERTAXON$Eritingis sp_ms_groote_eylandt$	Eritingis sp_ms_groote_eylandt
    2$_NO_HIGHERTAXON$Eritingis sp_ms_halls_creek$	Eritingis sp_ms_halls_creek
    1$_NO_HIGHERTAXON$Eritingis sp_ms_nr_kalbarri$	Eritingis sp_ms_nr_kalbarri
    7$_NO_HIGHERTAXON$Eritingis sp_x$	Eritingis sp_x
   15$_NO_HIGHERTAXON$Eritingis trivirgata$	Eritingis sp_ms_trivirgata
    1$_NO_HIGHERTAXON$Eritingis violina$	Eritingis sp_ms_violina
   31$_NO_HIGHERTAXON$Esocampylia sp_01$	Esocampylia sp_01
    4$_NO_HIGHERTAXON$Esocampylia sp_04$	Esocampylia sp_04
    3$_NO_HIGHERTAXON$Esocampylia sp_05$	Esocampylia sp_05
    1$_NO_HIGHERTAXON$Euagoras sp_1$	Euagoras sp_1
   14$_NO_HIGHERTAXON$Euander cicero$	Euander sp_ms_cicero
   75$_NO_HIGHERTAXON$Euander lacertosus$	Euander sp_ms_lacertosus
    5$_NO_HIGHERTAXON$Euaulana sp_01$	Euaulana sp_01
    9$_NO_HIGHERTAXON$Euaulana sp_02$	Euaulana sp_02
    1$_NO_HIGHERTAXON$Euaulana sp_03$	Euaulana sp_03
    1$_NO_HIGHERTAXON$Euaulana sp_04$	Euaulana sp_04
   26$_NO_HIGHERTAXON$Euaulana sp_ms_mt william$	Euaulana sp_ms_mt_william
   10$_NO_HIGHERTAXON$Euaulana tasmaniae$	Euaulana sp_ms_tasmaniae
    2$_NO_HIGHERTAXON$Eupachypeltis pilosus$	Eupachypeltis sp_ms_pilosus
    2$_NO_HIGHERTAXON$Eurynysius sp$	Eurynysius sp
   10$_NO_HIGHERTAXON$Everardia picta$	Everardia sp_ms_picta
  351$_NO_HIGHERTAXON$Exocarpocoris aurum$	Exocarpocoris sp_ms_aurum
    4$_NO_HIGHERTAXON$Exocarpocoris praegracilis$	Exocarpocoris sp_ms_praegracilis
    9$_NO_HIGHERTAXON$Exocarpocoris sp.$	Exocarpocoris sp.
  157$_NO_HIGHERTAXON$Exocarpocoris tantulus$	Exocarpocoris sp_ms_tantulus
    3$_NO_HIGHERTAXON$Felisacoris ponaponensis$	Felisacoris sp_ms_ponaponensis
    2$_NO_HIGHERTAXON$Felisacus adamsi$	Felisacus sp_ms_adamsi
   10$_NO_HIGHERTAXON$Felisacus amboinae$	Felisacus sp_ms_amboinae
    9$_NO_HIGHERTAXON$Felisacus dauloi$	Felisacus sp_ms_dauloi
  162$_NO_HIGHERTAXON$Felisacus elegantulus$	Felisacus sp_ms_elegantulus
  109$_NO_HIGHERTAXON$Felisacus filicicola$	Felisacus sp_ms_filicicola
    7$_NO_HIGHERTAXON$Felisacus jacobsoni$	Felisacus sp_ms_jacobsoni
   52$_NO_HIGHERTAXON$Felisacus javanus$	Felisacus sp_ms_javanus
   86$_NO_HIGHERTAXON$Felisacus longiceps$	Felisacus sp_ms_longiceps
   13$_NO_HIGHERTAXON$Felisacus magnificus$	Felisacus sp_ms_magnificus
    2$_NO_HIGHERTAXON$Felisacus minutus$	Felisacus sp_ms_minutus
   12$_NO_HIGHERTAXON$Felisacus nigrescens$	Felisacus sp_ms_nigrescens
   10$_NO_HIGHERTAXON$Felisacus philippinensis$	Felisacus sp_ms_philippinensis
    2$_NO_HIGHERTAXON$Felisacus rubricuneus$	Felisacus sp_ms_rubricuneus
    2$_NO_HIGHERTAXON$Felisacus signis$	Felisacus sp_ms_signis
   53$_NO_HIGHERTAXON$Felisacus sp$	Felisacus sp
    3$_NO_HIGHERTAXON$Felisacus sp_ms_australus$	Felisacus sp_ms_australus
    2$_NO_HIGHERTAXON$Felisacus sp_ms_bau$	Felisacus sp_ms_bau
    5$_NO_HIGHERTAXON$Felisacus sp_ms_bismarckiensis$	Felisacus sp_ms_bismarckiensis
   73$_NO_HIGHERTAXON$Felisacus sp_ms_caledonicus$	Felisacus sp_ms_caledonicus
    3$_NO_HIGHERTAXON$Felisacus sp_ms_cristobalus$	Felisacus sp_ms_cristobalus
    4$_NO_HIGHERTAXON$Felisacus sp_ms_fedori$	Felisacus sp_ms_fedori
    8$_NO_HIGHERTAXON$Felisacus sp_ms_lambkinae$	Felisacus sp_ms_lambkinae
   19$_NO_HIGHERTAXON$Felisacus sp_ms_linae$	Felisacus sp_ms_linae
   17$_NO_HIGHERTAXON$Felisacus sp_ms_lindbergae$	Felisacus sp_ms_lindbergae
    7$_NO_HIGHERTAXON$Felisacus sp_ms_liui$	Felisacus sp_ms_liui
   20$_NO_HIGHERTAXON$Felisacus sp_ms_lordhowensis$	Felisacus sp_ms_lordhowensis
    3$_NO_HIGHERTAXON$Felisacus sp_ms_malayensis$	Felisacus sp_ms_malayensis
   30$_NO_HIGHERTAXON$Felisacus sp_ms_meilingae$	Felisacus sp_ms_meilingae
   27$_NO_HIGHERTAXON$Felisacus sp_ms_myersi$	Felisacus sp_ms_myersi
    1$_NO_HIGHERTAXON$Felisacus sp_ms_ovalau$	Felisacus sp_ms_ovalau
   39$_NO_HIGHERTAXON$Felisacus sp_ms_schuhi$	Felisacus sp_ms_schuhi
   50$_NO_HIGHERTAXON$Felisacus sp_ms_senaru$	Felisacus sp_ms_senaru
    7$_NO_HIGHERTAXON$Felisacus sp_ms_solomonicus$	Felisacus sp_ms_solomonicus
   23$_NO_HIGHERTAXON$Felisacus sp_ms_tanna$	Felisacus sp_ms_tanna
   31$_NO_HIGHERTAXON$Felisacus sp_ms_vitilevu$	Felisacus sp_ms_vitilevu
    4$_NO_HIGHERTAXON$Felisacus sp_ms_wangae$	Felisacus sp_ms_wangae
   12$_NO_HIGHERTAXON$Felisacus sp_ms_zuparkoi$	Felisacus sp_ms_zuparkoi
    6$_NO_HIGHERTAXON$Fontejus sp_a$	Fontejus sp_a
    4$_NO_HIGHERTAXON$Fontejus westraliensis$	Fontejus sp_ms_westraliensis
  125$_NO_HIGHERTAXON$Froggattia olivinia$	Froggattia sp_ms_olivinia
  124$_NO_HIGHERTAXON$Froggattia sp.$	Froggattia sp.
    9$_NO_HIGHERTAXON$Fronsetta geraldtoni$	Fronsetta sp_ms_geraldtoni
    3$_NO_HIGHERTAXON$Fronsetta maculatus$	Fronsetta sp_ms_maculatus
    1$_NO_HIGHERTAXON$Furcilliger comptus$	Furcilliger sp_ms_comptus
    7$_NO_HIGHERTAXON$Furcilliger sp_ms_kuranda$	Furcilliger sp_ms_kuranda
    1$_NO_HIGHERTAXON$Germalus sp_1$	Germalus sp_1
   38$_NO_HIGHERTAXON$Gn_A sp_1$	Gn_A sp_1
   55$_NO_HIGHERTAXON$Gn_A sp_2$	Gn_A sp_2
    7$_NO_HIGHERTAXON$Gn_B sp_1$	Gn_B sp_1
    7$_NO_HIGHERTAXON$Gn_BB_Orthotylini sp_bbcre11_ac$	Gn_BB_Orthotylini sp_bbcre11_ac
    3$_NO_HIGHERTAXON$Gn_BB_Orthotylini sp_bbcre11_ad$	Gn_BB_Orthotylini sp_bbcre11_ad
    3$_NO_HIGHERTAXON$Gn_BB_Orthotylini sp_pbitas04_stripey$	Gn_BB_Orthotylini sp_pbitas04_stripey
   88$_NO_HIGHERTAXON$Gn_C sp_1$	Gn_C sp_1
   14$_NO_HIGHERTAXON$Gn_KNG01 sp_ms_kng01$	Gn_KNG01 sp_ms_kng01
   11$_NO_HIGHERTAXON$Gn_LeucophoropteriniGn1 sp_1$	Gn_LeucophoropteriniGn1 sp_1
    3$_NO_HIGHERTAXON$Gn_OrthotyliniGp1 sp$	Gn_OrthotyliniGp1 sp
  249$_NO_HIGHERTAXON$Gn_OrthotyliniGp1 sp_005$	Gn_OrthotyliniGp1 sp_005
   23$_NO_HIGHERTAXON$Gn_OrthotyliniGp1 sp_006$	Gn_OrthotyliniGp1 sp_006
    2$_NO_HIGHERTAXON$Gn_OrthotyliniGp1 sp_nsp$	Gn_OrthotyliniGp1 sp_nsp
    3$_NO_HIGHERTAXON$Gn_OrthotyliniGp1 sp_w_orange_cuneus_2prong_tergproc$	Gn_OrthotyliniGp1 sp_w_orange_cuneus_2prong_tergproc
   68$_NO_HIGHERTAXON$Gn_OrthotyliniGp10 sp_001$	Gn_OrthotyliniGp10 sp_001
  198$_NO_HIGHERTAXON$Gn_OrthotyliniGp11 sp_001$	Gn_OrthotyliniGp11 sp_001
   65$_NO_HIGHERTAXON$Gn_OrthotyliniGp11 sp_002$	Gn_OrthotyliniGp11 sp_002
   25$_NO_HIGHERTAXON$Gn_OrthotyliniGp11 sp_003$	Gn_OrthotyliniGp11 sp_003
   15$_NO_HIGHERTAXON$Gn_OrthotyliniGp11 sp_004$	Gn_OrthotyliniGp11 sp_004
    2$_NO_HIGHERTAXON$Gn_OrthotyliniGp11 sp_005$	Gn_OrthotyliniGp11 sp_005
    1$_NO_HIGHERTAXON$Gn_OrthotyliniGp11 sp_nsp_001$	Gn_OrthotyliniGp11 sp_nsp_001
   20$_NO_HIGHERTAXON$Gn_OrthotyliniGp12 sp_001$	Gn_OrthotyliniGp12 sp_001
   84$_NO_HIGHERTAXON$Gn_OrthotyliniGp12 sp_002$	Gn_OrthotyliniGp12 sp_002
   83$_NO_HIGHERTAXON$Gn_OrthotyliniGp12 sp_003$	Gn_OrthotyliniGp12 sp_003
   52$_NO_HIGHERTAXON$Gn_OrthotyliniGp12 sp_004$	Gn_OrthotyliniGp12 sp_004
   17$_NO_HIGHERTAXON$Gn_OrthotyliniGp12 sp_005$	Gn_OrthotyliniGp12 sp_005
    3$_NO_HIGHERTAXON$Gn_OrthotyliniGp12 sp_006$	Gn_OrthotyliniGp12 sp_006
   65$_NO_HIGHERTAXON$Gn_OrthotyliniGp12 sp_007$	Gn_OrthotyliniGp12 sp_007
    4$_NO_HIGHERTAXON$Gn_OrthotyliniGp12 sp_008$	Gn_OrthotyliniGp12 sp_008
    1$_NO_HIGHERTAXON$Gn_OrthotyliniGp12 sp_009$	Gn_OrthotyliniGp12 sp_009
   37$_NO_HIGHERTAXON$Gn_OrthotyliniGp13 sp_001$	Gn_OrthotyliniGp13 sp_001
   69$_NO_HIGHERTAXON$Gn_OrthotyliniGp14 sp_001$	Gn_OrthotyliniGp14 sp_001
    2$_NO_HIGHERTAXON$Gn_OrthotyliniGp14 sp_elong_senslobe_on_lp$	Gn_OrthotyliniGp14 sp_elong_senslobe_on_lp
   16$_NO_HIGHERTAXON$Gn_OrthotyliniGp15 sp_001$	Gn_OrthotyliniGp15 sp_001
   22$_NO_HIGHERTAXON$Gn_OrthotyliniGp15 sp_002$	Gn_OrthotyliniGp15 sp_002
   10$_NO_HIGHERTAXON$Gn_OrthotyliniGp15 sp_003$	Gn_OrthotyliniGp15 sp_003
   11$_NO_HIGHERTAXON$Gn_OrthotyliniGp15 sp_004$	Gn_OrthotyliniGp15 sp_004
  120$_NO_HIGHERTAXON$Gn_OrthotyliniGp16 sp_001$	Gn_OrthotyliniGp16 sp_001
   10$_NO_HIGHERTAXON$Gn_OrthotyliniGp17 sp_001$	Gn_OrthotyliniGp17 sp_001
    6$_NO_HIGHERTAXON$Gn_OrthotyliniGp17 sp_002$	Gn_OrthotyliniGp17 sp_002
   51$_NO_HIGHERTAXON$Gn_OrthotyliniGp18 sp_001$	Gn_OrthotyliniGp18 sp_001
    4$_NO_HIGHERTAXON$Gn_OrthotyliniGp1C sp_brachypt_females$	Gn_OrthotyliniGp1C sp_brachypt_females
    2$_NO_HIGHERTAXON$Gn_OrthotyliniGp1C sp_nsp$	Gn_OrthotyliniGp1C sp_nsp
    1$_NO_HIGHERTAXON$Gn_OrthotyliniGp1C sp_sim_to_gp031$	Gn_OrthotyliniGp1C sp_sim_to_gp031
    2$_NO_HIGHERTAXON$Gn_OrthotyliniGp1C sp_subhyaline$	Gn_OrthotyliniGp1C sp_subhyaline
    1$_NO_HIGHERTAXON$Gn_OrthotyliniGp2 sp_002$	Gn_OrthotyliniGp2 sp_002
    3$_NO_HIGHERTAXON$Gn_OrthotyliniGp2 sp_006$	Gn_OrthotyliniGp2 sp_006
   20$_NO_HIGHERTAXON$Gn_OrthotyliniGp2 sp_007$	Gn_OrthotyliniGp2 sp_007
    6$_NO_HIGHERTAXON$Gn_OrthotyliniGp2 sp_008$	Gn_OrthotyliniGp2 sp_008
   16$_NO_HIGHERTAXON$Gn_OrthotyliniGp20 sp_001$	Gn_OrthotyliniGp20 sp_001
   73$_NO_HIGHERTAXON$Gn_OrthotyliniGp20 sp_002$	Gn_OrthotyliniGp20 sp_002
    4$_NO_HIGHERTAXON$Gn_OrthotyliniGp20 sp_003$	Gn_OrthotyliniGp20 sp_003
   20$_NO_HIGHERTAXON$Gn_OrthotyliniGp20 sp_005$	Gn_OrthotyliniGp20 sp_005
    1$_NO_HIGHERTAXON$Gn_OrthotyliniGp20 sp_nsp_001$	Gn_OrthotyliniGp20 sp_nsp_001
    1$_NO_HIGHERTAXON$Gn_OrthotyliniGp20 sp_sp$	Gn_OrthotyliniGp20 sp_sp
   19$_NO_HIGHERTAXON$Gn_OrthotyliniGp22 sp_001$	Gn_OrthotyliniGp22 sp_001
   22$_NO_HIGHERTAXON$Gn_OrthotyliniGp23 sp_001$	Gn_OrthotyliniGp23 sp_001
    9$_NO_HIGHERTAXON$Gn_OrthotyliniGp23 sp_002$	Gn_OrthotyliniGp23 sp_002
    5$_NO_HIGHERTAXON$Gn_OrthotyliniGp26 sp_001$	Gn_OrthotyliniGp26 sp_001
   11$_NO_HIGHERTAXON$Gn_OrthotyliniGp28 sp_001$	Gn_OrthotyliniGp28 sp_001
   14$_NO_HIGHERTAXON$Gn_OrthotyliniGp28 sp_002$	Gn_OrthotyliniGp28 sp_002
   31$_NO_HIGHERTAXON$Gn_OrthotyliniGp29 sp_001$	Gn_OrthotyliniGp29 sp_001
   12$_NO_HIGHERTAXON$Gn_OrthotyliniGp2B sp_nsp_001$	Gn_OrthotyliniGp2B sp_nsp_001
    3$_NO_HIGHERTAXON$Gn_OrthotyliniGp2B sp_nsp_002$	Gn_OrthotyliniGp2B sp_nsp_002
    3$_NO_HIGHERTAXON$Gn_OrthotyliniGp2B sp_nsp_003$	Gn_OrthotyliniGp2B sp_nsp_003
   56$_NO_HIGHERTAXON$Gn_OrthotyliniGp3 sp_002$	Gn_OrthotyliniGp3 sp_002
   16$_NO_HIGHERTAXON$Gn_OrthotyliniGp3 sp_003$	Gn_OrthotyliniGp3 sp_003
   37$_NO_HIGHERTAXON$Gn_OrthotyliniGp3 sp_004$	Gn_OrthotyliniGp3 sp_004
   28$_NO_HIGHERTAXON$Gn_OrthotyliniGp30 sp_001$	Gn_OrthotyliniGp30 sp_001
    6$_NO_HIGHERTAXON$Gn_OrthotyliniGp31 sp_001$	Gn_OrthotyliniGp31 sp_001
   10$_NO_HIGHERTAXON$Gn_OrthotyliniGp31 sp_002$	Gn_OrthotyliniGp31 sp_002
    5$_NO_HIGHERTAXON$Gn_OrthotyliniGp31 sp_005$	Gn_OrthotyliniGp31 sp_005
    4$_NO_HIGHERTAXON$Gn_OrthotyliniGp32 sp_001$	Gn_OrthotyliniGp32 sp_001
    8$_NO_HIGHERTAXON$Gn_OrthotyliniGp33 sp_001$	Gn_OrthotyliniGp33 sp_001
   30$_NO_HIGHERTAXON$Gn_OrthotyliniGp34 sp_001$	Gn_OrthotyliniGp34 sp_001
   25$_NO_HIGHERTAXON$Gn_OrthotyliniGp34 sp_002$	Gn_OrthotyliniGp34 sp_002
    3$_NO_HIGHERTAXON$Gn_OrthotyliniGp34 sp_003$	Gn_OrthotyliniGp34 sp_003
    4$_NO_HIGHERTAXON$Gn_OrthotyliniGp34 sp_004$	Gn_OrthotyliniGp34 sp_004
    3$_NO_HIGHERTAXON$Gn_OrthotyliniGp35 sp_001$	Gn_OrthotyliniGp35 sp_001
    1$_NO_HIGHERTAXON$Gn_OrthotyliniGp39 sp_acute_senslobe_on_lp$	Gn_OrthotyliniGp39 sp_acute_senslobe_on_lp
    1$_NO_HIGHERTAXON$Gn_OrthotyliniGp39 sp_bimbowrie_stn$	Gn_OrthotyliniGp39 sp_bimbowrie_stn
    3$_NO_HIGHERTAXON$Gn_OrthotyliniGp39 sp_green_spot_red_line$	Gn_OrthotyliniGp39 sp_green_spot_red_line
    1$_NO_HIGHERTAXON$Gn_OrthotyliniGp39 sp_large_eyes$	Gn_OrthotyliniGp39 sp_large_eyes
    1$_NO_HIGHERTAXON$Gn_OrthotyliniGp39 sp_large_eyes_narrow_lp$	Gn_OrthotyliniGp39 sp_large_eyes_narrow_lp
    1$_NO_HIGHERTAXON$Gn_OrthotyliniGp39 sp_long_head$	Gn_OrthotyliniGp39 sp_long_head
    1$_NO_HIGHERTAXON$Gn_OrthotyliniGp39 sp_malbooma$	Gn_OrthotyliniGp39 sp_malbooma
    1$_NO_HIGHERTAXON$Gn_OrthotyliniGp39 sp_mitcham$	Gn_OrthotyliniGp39 sp_mitcham
   12$_NO_HIGHERTAXON$Gn_OrthotyliniGp39 sp_nsp$	Gn_OrthotyliniGp39 sp_nsp
    4$_NO_HIGHERTAXON$Gn_OrthotyliniGp39 sp_nsp_001$	Gn_OrthotyliniGp39 sp_nsp_001
    1$_NO_HIGHERTAXON$Gn_OrthotyliniGp39 sp_orange_cuneus_black_scale_setae$	Gn_OrthotyliniGp39 sp_orange_cuneus_black_scale_setae
    1$_NO_HIGHERTAXON$Gn_OrthotyliniGp39 sp_red_venter_and_cuneal_apex$	Gn_OrthotyliniGp39 sp_red_venter_and_cuneal_apex
    1$_NO_HIGHERTAXON$Gn_OrthotyliniGp39 sp_salad_fork_lp$	Gn_OrthotyliniGp39 sp_salad_fork_lp
    1$_NO_HIGHERTAXON$Gn_OrthotyliniGp39 sp_tallaringa_well$	Gn_OrthotyliniGp39 sp_tallaringa_well
    1$_NO_HIGHERTAXON$Gn_OrthotyliniGp39 sp_tipperary_stn$	Gn_OrthotyliniGp39 sp_tipperary_stn
    1$_NO_HIGHERTAXON$Gn_OrthotyliniGp39 sp_yellow_large_lp$	Gn_OrthotyliniGp39 sp_yellow_large_lp
    9$_NO_HIGHERTAXON$Gn_OrthotyliniGp4 sp_001$	Gn_OrthotyliniGp4 sp_001
   19$_NO_HIGHERTAXON$Gn_OrthotyliniGp4 sp_004$	Gn_OrthotyliniGp4 sp_004
   11$_NO_HIGHERTAXON$Gn_OrthotyliniGp4 sp_006$	Gn_OrthotyliniGp4 sp_006
    1$_NO_HIGHERTAXON$Gn_OrthotyliniGp4 sp_008$	Gn_OrthotyliniGp4 sp_008
    1$_NO_HIGHERTAXON$Gn_OrthotyliniGp4 sp_009$	Gn_OrthotyliniGp4 sp_009
    8$_NO_HIGHERTAXON$Gn_OrthotyliniGp4 sp_010$	Gn_OrthotyliniGp4 sp_010
   21$_NO_HIGHERTAXON$Gn_OrthotyliniGp4 sp_012$	Gn_OrthotyliniGp4 sp_012
   20$_NO_HIGHERTAXON$Gn_OrthotyliniGp4 sp_013$	Gn_OrthotyliniGp4 sp_013
    2$_NO_HIGHERTAXON$Gn_OrthotyliniGp4 sp_015$	Gn_OrthotyliniGp4 sp_015
    4$_NO_HIGHERTAXON$Gn_OrthotyliniGp4 sp_016$	Gn_OrthotyliniGp4 sp_016
   16$_NO_HIGHERTAXON$Gn_OrthotyliniGp4 sp_017$	Gn_OrthotyliniGp4 sp_017
    4$_NO_HIGHERTAXON$Gn_OrthotyliniGp4 sp_018$	Gn_OrthotyliniGp4 sp_018
   42$_NO_HIGHERTAXON$Gn_OrthotyliniGp4 sp_019$	Gn_OrthotyliniGp4 sp_019
    3$_NO_HIGHERTAXON$Gn_OrthotyliniGp4 sp_020$	Gn_OrthotyliniGp4 sp_020
    6$_NO_HIGHERTAXON$Gn_OrthotyliniGp4 sp_021$	Gn_OrthotyliniGp4 sp_021
    4$_NO_HIGHERTAXON$Gn_OrthotyliniGp4 sp_035$	Gn_OrthotyliniGp4 sp_035
    2$_NO_HIGHERTAXON$Gn_OrthotyliniGp4C sp_nsp_001$	Gn_OrthotyliniGp4C sp_nsp_001
    2$_NO_HIGHERTAXON$Gn_OrthotyliniGp4C sp_nsp_002$	Gn_OrthotyliniGp4C sp_nsp_002
    5$_NO_HIGHERTAXON$Gn_OrthotyliniGp4C sp_nsp_003$	Gn_OrthotyliniGp4C sp_nsp_003
   18$_NO_HIGHERTAXON$Gn_OrthotyliniGp4C sp_nsp_004$	Gn_OrthotyliniGp4C sp_nsp_004
   12$_NO_HIGHERTAXON$Gn_OrthotyliniGp4C sp_nsp_005$	Gn_OrthotyliniGp4C sp_nsp_005
   13$_NO_HIGHERTAXON$Gn_OrthotyliniGp4C sp_nsp_006$	Gn_OrthotyliniGp4C sp_nsp_006
    3$_NO_HIGHERTAXON$Gn_OrthotyliniGp4C sp_nsp_007$	Gn_OrthotyliniGp4C sp_nsp_007
    1$_NO_HIGHERTAXON$Gn_OrthotyliniGp4C sp_nsp_008$	Gn_OrthotyliniGp4C sp_nsp_008
   16$_NO_HIGHERTAXON$Gn_OrthotyliniGp4C sp_nsp_009$	Gn_OrthotyliniGp4C sp_nsp_009
    3$_NO_HIGHERTAXON$Gn_OrthotyliniGp4C sp_nsp_010$	Gn_OrthotyliniGp4C sp_nsp_010
    4$_NO_HIGHERTAXON$Gn_OrthotyliniGp4C sp_nsp_011$	Gn_OrthotyliniGp4C sp_nsp_011
    4$_NO_HIGHERTAXON$Gn_OrthotyliniGp4C sp_nsp_012$	Gn_OrthotyliniGp4C sp_nsp_012
    4$_NO_HIGHERTAXON$Gn_OrthotyliniGp4C sp_nsp_013$	Gn_OrthotyliniGp4C sp_nsp_013
   10$_NO_HIGHERTAXON$Gn_OrthotyliniGp4C sp_nsp_018$	Gn_OrthotyliniGp4C sp_nsp_018
    8$_NO_HIGHERTAXON$Gn_OrthotyliniGp4C sp_serpentine_lakes$	Gn_OrthotyliniGp4C sp_serpentine_lakes
    1$_NO_HIGHERTAXON$Gn_OrthotyliniGp4C sp_south_of_menzies$	Gn_OrthotyliniGp4C sp_south_of_menzies
  110$_NO_HIGHERTAXON$Gn_OrthotyliniGp5 sp_001$	Gn_OrthotyliniGp5 sp_001
   15$_NO_HIGHERTAXON$Gn_OrthotyliniGp5 sp_002$	Gn_OrthotyliniGp5 sp_002
  228$_NO_HIGHERTAXON$Gn_OrthotyliniGp5 sp_003$	Gn_OrthotyliniGp5 sp_003
   30$_NO_HIGHERTAXON$Gn_OrthotyliniGp5 sp_004$	Gn_OrthotyliniGp5 sp_004
   28$_NO_HIGHERTAXON$Gn_OrthotyliniGp5 sp_005$	Gn_OrthotyliniGp5 sp_005
    4$_NO_HIGHERTAXON$Gn_OrthotyliniGp5 sp_006$	Gn_OrthotyliniGp5 sp_006
   48$_NO_HIGHERTAXON$Gn_OrthotyliniGp5 sp_007$	Gn_OrthotyliniGp5 sp_007
    2$_NO_HIGHERTAXON$Gn_OrthotyliniGp5 sp_008$	Gn_OrthotyliniGp5 sp_008
   96$_NO_HIGHERTAXON$Gn_OrthotyliniGp6 sp_001$	Gn_OrthotyliniGp6 sp_001
   46$_NO_HIGHERTAXON$Gn_OrthotyliniGp6 sp_002$	Gn_OrthotyliniGp6 sp_002
    3$_NO_HIGHERTAXON$Gn_OrthotyliniGp6 sp_003$	Gn_OrthotyliniGp6 sp_003
  116$_NO_HIGHERTAXON$Gn_OrthotyliniGp7 sp_001$	Gn_OrthotyliniGp7 sp_001
   21$_NO_HIGHERTAXON$Gn_OrthotyliniGp7 sp_002$	Gn_OrthotyliniGp7 sp_002
   41$_NO_HIGHERTAXON$Gn_OrthotyliniGp7 sp_003$	Gn_OrthotyliniGp7 sp_003
   24$_NO_HIGHERTAXON$Gn_OrthotyliniGp7 sp_004$	Gn_OrthotyliniGp7 sp_004
   18$_NO_HIGHERTAXON$Gn_OrthotyliniGp7 sp_005$	Gn_OrthotyliniGp7 sp_005
   10$_NO_HIGHERTAXON$Gn_OrthotyliniGp7 sp_006$	Gn_OrthotyliniGp7 sp_006
   11$_NO_HIGHERTAXON$Gn_OrthotyliniGp7 sp_007$	Gn_OrthotyliniGp7 sp_007
   17$_NO_HIGHERTAXON$Gn_OrthotyliniGp7 sp_009$	Gn_OrthotyliniGp7 sp_009
    2$_NO_HIGHERTAXON$Gn_OrthotyliniGp7 sp_013$	Gn_OrthotyliniGp7 sp_013
    5$_NO_HIGHERTAXON$Gn_OrthotyliniGp7 sp_nsp_001$	Gn_OrthotyliniGp7 sp_nsp_001
    7$_NO_HIGHERTAXON$Gn_OrthotyliniGp7 sp_nsp_002$	Gn_OrthotyliniGp7 sp_nsp_002
    7$_NO_HIGHERTAXON$Gn_OrthotyliniGp7 sp_nsp_004$	Gn_OrthotyliniGp7 sp_nsp_004
    6$_NO_HIGHERTAXON$Gn_OrthotyliniGp7B sp_doubled_over_rp$	Gn_OrthotyliniGp7B sp_doubled_over_rp
   32$_NO_HIGHERTAXON$Gn_OrthotyliniGp7B sp_nsp$	Gn_OrthotyliniGp7B sp_nsp
  102$_NO_HIGHERTAXON$Gn_OrthotyliniGp7B sp_nsp_001$	Gn_OrthotyliniGp7B sp_nsp_001
    5$_NO_HIGHERTAXON$Gn_OrthotyliniGp7B sp_nsp_002$	Gn_OrthotyliniGp7B sp_nsp_002
   11$_NO_HIGHERTAXON$Gn_OrthotyliniGp8 sp_001$	Gn_OrthotyliniGp8 sp_001
    1$_NO_HIGHERTAXON$Gn_OrthotyliniGp8 sp_nsp$	Gn_OrthotyliniGp8 sp_nsp
    7$_NO_HIGHERTAXON$Gn_OrthotyliniGp8B sp_nsp_001$	Gn_OrthotyliniGp8B sp_nsp_001
    2$_NO_HIGHERTAXON$Gn_OrthotyliniGp8B sp_nsp_002$	Gn_OrthotyliniGp8B sp_nsp_002
   16$_NO_HIGHERTAXON$Gn_OrthotyliniGp8B sp_nsp_003$	Gn_OrthotyliniGp8B sp_nsp_003
    3$_NO_HIGHERTAXON$Gn_OrthotyliniGp8B sp_nsp_004$	Gn_OrthotyliniGp8B sp_nsp_004
    2$_NO_HIGHERTAXON$Gn_OrthotyliniGp8B sp_nsp_005$	Gn_OrthotyliniGp8B sp_nsp_005
    8$_NO_HIGHERTAXON$Gn_OrthotyliniGp9 sp_001$	Gn_OrthotyliniGp9 sp_001
   78$_NO_HIGHERTAXON$Gn_OrthotyliniGp9 sp_002$	Gn_OrthotyliniGp9 sp_002
   25$_NO_HIGHERTAXON$Gn_OrthotyliniGp9 sp_003$	Gn_OrthotyliniGp9 sp_003
   12$_NO_HIGHERTAXON$Gn_OrthotyliniGp9 sp_004$	Gn_OrthotyliniGp9 sp_004
   20$_NO_HIGHERTAXON$Gn_OrthotyliniGp9 sp_005$	Gn_OrthotyliniGp9 sp_005
    2$_NO_HIGHERTAXON$Gn_OrthotyliniGp_sickle_shaped_LP sp_001$	Gn_OrthotyliniGp_sickle_shaped_LP sp_001
    1$_NO_HIGHERTAXON$Gn_Orthotylini_AU_unplaced sp$	Gn_Orthotylini_AU_unplaced sp
   23$_NO_HIGHERTAXON$Gn_Solomonocoris sp_ms_k26$	Gn_Solomonocoris sp_ms_k26
    6$_NO_HIGHERTAXON$Gn_ms_Ambyxella sp_ms_bicolouratus$	Gn_ms_Ambyxella sp_ms_bicolouratus
   26$_NO_HIGHERTAXON$Gn_ms_Arlecchinomiris sp_ms_preecei$	Gn_ms_Arlecchinomiris sp_ms_preecei
    4$_NO_HIGHERTAXON$Gn_ms_Arlecchinomiris sp_ms_rubralytos$	Gn_ms_Arlecchinomiris sp_ms_rubralytos
   57$_NO_HIGHERTAXON$Gn_ms_Austrobucculus sp$	Gn_ms_Austrobucculus sp
    9$_NO_HIGHERTAXON$Gn_ms_Austrobucculus sp_ms_asquithi$	Gn_ms_Austrobucculus sp_ms_asquithi
    1$_NO_HIGHERTAXON$Gn_ms_Austrobucculus sp_ms_bicolor$	Gn_ms_Austrobucculus sp_ms_bicolor
    1$_NO_HIGHERTAXON$Gn_ms_Austrobucculus sp_ms_houstoni$	Gn_ms_Austrobucculus sp_ms_houstoni
   17$_NO_HIGHERTAXON$Gn_ms_Austrobucculus sp_ms_schuhi$	Gn_ms_Austrobucculus sp_ms_schuhi
    1$_NO_HIGHERTAXON$Gn_ms_Austrobucculus sp_s040$	Gn_ms_Austrobucculus sp_s040
    2$_NO_HIGHERTAXON$Gn_ms_Austrophorus sp$	Gn_ms_Austrophorus sp
    1$_NO_HIGHERTAXON$Gn_ms_Austrophorus sp_ms_nigrocuneatus$	Gn_ms_Austrophorus sp_ms_nigrocuneatus
    1$_NO_HIGHERTAXON$Gn_ms_Austrotylus sp$	Gn_ms_Austrotylus sp
    4$_NO_HIGHERTAXON$Gn_ms_Austrotylus sp_ms_banjiwarn$	Gn_ms_Austrotylus sp_ms_banjiwarn
    2$_NO_HIGHERTAXON$Gn_ms_Austrotylus sp_ms_myrmecoroides$	Gn_ms_Austrotylus sp_ms_myrmecoroides
    3$_NO_HIGHERTAXON$Gn_ms_Austrotylus sp_ms_translineatus$	Gn_ms_Austrotylus sp_ms_translineatus
    1$_NO_HIGHERTAXON$Gn_ms_Bilbonotus sp$	Gn_ms_Bilbonotus sp
    1$_NO_HIGHERTAXON$Gn_ms_Bilbonotus sp_ms_aitkeni$	Gn_ms_Bilbonotus sp_ms_aitkeni
    2$_NO_HIGHERTAXON$Gn_ms_Bilbonotus sp_ms_albaclavata$	Gn_ms_Bilbonotus sp_ms_albaclavata
    1$_NO_HIGHERTAXON$Gn_ms_Bilbonotus sp_ms_alcoota$	Gn_ms_Bilbonotus sp_ms_alcoota
    1$_NO_HIGHERTAXON$Gn_ms_Bilbonotus sp_ms_arcoona$	Gn_ms_Bilbonotus sp_ms_arcoona
    1$_NO_HIGHERTAXON$Gn_ms_Bilbonotus sp_ms_arkaroola$	Gn_ms_Bilbonotus sp_ms_arkaroola
    1$_NO_HIGHERTAXON$Gn_ms_Bilbonotus sp_ms_armstrongi$	Gn_ms_Bilbonotus sp_ms_armstrongi
    4$_NO_HIGHERTAXON$Gn_ms_Bilbonotus sp_ms_aspersus$	Gn_ms_Bilbonotus sp_ms_aspersus
    1$_NO_HIGHERTAXON$Gn_ms_Bilbonotus sp_ms_bifasciatus$	Gn_ms_Bilbonotus sp_ms_bifasciatus
    2$_NO_HIGHERTAXON$Gn_ms_Bilbonotus sp_ms_boganensis$	Gn_ms_Bilbonotus sp_ms_boganensis
    2$_NO_HIGHERTAXON$Gn_ms_Bilbonotus sp_ms_cantrelli$	Gn_ms_Bilbonotus sp_ms_cantrelli
    1$_NO_HIGHERTAXON$Gn_ms_Bilbonotus sp_ms_canungra$	Gn_ms_Bilbonotus sp_ms_canungra
    2$_NO_HIGHERTAXON$Gn_ms_Bilbonotus sp_ms_coronata$	Gn_ms_Bilbonotus sp_ms_coronata
    1$_NO_HIGHERTAXON$Gn_ms_Bilbonotus sp_ms_cunamullaenensis$	Gn_ms_Bilbonotus sp_ms_cunamullaenensis
    1$_NO_HIGHERTAXON$Gn_ms_Bilbonotus sp_ms_douglasi$	Gn_ms_Bilbonotus sp_ms_douglasi
    3$_NO_HIGHERTAXON$Gn_ms_Bilbonotus sp_ms_everardensis$	Gn_ms_Bilbonotus sp_ms_everardensis
    2$_NO_HIGHERTAXON$Gn_ms_Bilbonotus sp_ms_fasciatus$	Gn_ms_Bilbonotus sp_ms_fasciatus
    4$_NO_HIGHERTAXON$Gn_ms_Bilbonotus sp_ms_gawlerensis$	Gn_ms_Bilbonotus sp_ms_gawlerensis
    1$_NO_HIGHERTAXON$Gn_ms_Bilbonotus sp_ms_grossi$	Gn_ms_Bilbonotus sp_ms_grossi
    1$_NO_HIGHERTAXON$Gn_ms_Bilbonotus sp_ms_hanichi$	Gn_ms_Bilbonotus sp_ms_hanichi
    1$_NO_HIGHERTAXON$Gn_ms_Bilbonotus sp_ms_humbertensis$	Gn_ms_Bilbonotus sp_ms_humbertensis
    1$_NO_HIGHERTAXON$Gn_ms_Bilbonotus sp_ms_janae$	Gn_ms_Bilbonotus sp_ms_janae
    1$_NO_HIGHERTAXON$Gn_ms_Bilbonotus sp_ms_kalbarri$	Gn_ms_Bilbonotus sp_ms_kalbarri
   12$_NO_HIGHERTAXON$Gn_ms_Bilbonotus sp_ms_kurlge$	Gn_ms_Bilbonotus sp_ms_kurlge
    1$_NO_HIGHERTAXON$Gn_ms_Bilbonotus sp_ms_linearis$	Gn_ms_Bilbonotus sp_ms_linearis
    5$_NO_HIGHERTAXON$Gn_ms_Bilbonotus sp_ms_macrommata$	Gn_ms_Bilbonotus sp_ms_macrommata
    1$_NO_HIGHERTAXON$Gn_ms_Bilbonotus sp_ms_maculatus$	Gn_ms_Bilbonotus sp_ms_maculatus
    2$_NO_HIGHERTAXON$Gn_ms_Bilbonotus sp_ms_major$	Gn_ms_Bilbonotus sp_ms_major
   14$_NO_HIGHERTAXON$Gn_ms_Bilbonotus sp_ms_marmoratus$	Gn_ms_Bilbonotus sp_ms_marmoratus
    4$_NO_HIGHERTAXON$Gn_ms_Bilbonotus sp_ms_mathewsi$	Gn_ms_Bilbonotus sp_ms_mathewsi
    1$_NO_HIGHERTAXON$Gn_ms_Bilbonotus sp_ms_mcalpinei$	Gn_ms_Bilbonotus sp_ms_mcalpinei
    2$_NO_HIGHERTAXON$Gn_ms_Bilbonotus sp_ms_minor$	Gn_ms_Bilbonotus sp_ms_minor
    1$_NO_HIGHERTAXON$Gn_ms_Bilbonotus sp_ms_montecollina$	Gn_ms_Bilbonotus sp_ms_montecollina
    2$_NO_HIGHERTAXON$Gn_ms_Bilbonotus sp_ms_monteithi$	Gn_ms_Bilbonotus sp_ms_monteithi
    3$_NO_HIGHERTAXON$Gn_ms_Bilbonotus sp_ms_morganensis$	Gn_ms_Bilbonotus sp_ms_morganensis
    1$_NO_HIGHERTAXON$Gn_ms_Bilbonotus sp_ms_ngarkatensis$	Gn_ms_Bilbonotus sp_ms_ngarkatensis
    1$_NO_HIGHERTAXON$Gn_ms_Bilbonotus sp_ms_nigrascutellum$	Gn_ms_Bilbonotus sp_ms_nigrascutellum
    3$_NO_HIGHERTAXON$Gn_ms_Bilbonotus sp_ms_norsemanensis$	Gn_ms_Bilbonotus sp_ms_norsemanensis
    1$_NO_HIGHERTAXON$Gn_ms_Bilbonotus sp_ms_pernalty$	Gn_ms_Bilbonotus sp_ms_pernalty
    1$_NO_HIGHERTAXON$Gn_ms_Bilbonotus sp_ms_pilbarensis$	Gn_ms_Bilbonotus sp_ms_pilbarensis
    2$_NO_HIGHERTAXON$Gn_ms_Bilbonotus sp_ms_pilosus$	Gn_ms_Bilbonotus sp_ms_pilosus
    3$_NO_HIGHERTAXON$Gn_ms_Bilbonotus sp_ms_pinkawillinie$	Gn_ms_Bilbonotus sp_ms_pinkawillinie
    3$_NO_HIGHERTAXON$Gn_ms_Bilbonotus sp_ms_rentzi$	Gn_ms_Bilbonotus sp_ms_rentzi
    1$_NO_HIGHERTAXON$Gn_ms_Bilbonotus sp_ms_rossanae$	Gn_ms_Bilbonotus sp_ms_rossanae
    1$_NO_HIGHERTAXON$Gn_ms_Bilbonotus sp_ms_rubramaculatus$	Gn_ms_Bilbonotus sp_ms_rubramaculatus
    1$_NO_HIGHERTAXON$Gn_ms_Bilbonotus sp_ms_schuhi$	Gn_ms_Bilbonotus sp_ms_schuhi
    2$_NO_HIGHERTAXON$Gn_ms_Bilbonotus sp_ms_striata$	Gn_ms_Bilbonotus sp_ms_striata
    1$_NO_HIGHERTAXON$Gn_ms_Bilbonotus sp_ms_tindalei$	Gn_ms_Bilbonotus sp_ms_tindalei
    9$_NO_HIGHERTAXON$Gn_ms_Bilbonotus sp_ms_uncinata$	Gn_ms_Bilbonotus sp_ms_uncinata
    1$_NO_HIGHERTAXON$Gn_ms_Bilbonotus sp_ms_windorah$	Gn_ms_Bilbonotus sp_ms_windorah
    2$_NO_HIGHERTAXON$Gn_ms_Bilbonotus sp_ms_yunta$	Gn_ms_Bilbonotus sp_ms_yunta
    5$_NO_HIGHERTAXON$Gn_ms_Bilbonotus sp_s021$	Gn_ms_Bilbonotus sp_s021
    1$_NO_HIGHERTAXON$Gn_ms_Bilbonotus sp_s025$	Gn_ms_Bilbonotus sp_s025
    1$_NO_HIGHERTAXON$Gn_ms_Bilbonotus sp_s051$	Gn_ms_Bilbonotus sp_s051
    1$_NO_HIGHERTAXON$Gn_ms_Bilbonotus sp_s052$	Gn_ms_Bilbonotus sp_s052
    1$_NO_HIGHERTAXON$Gn_ms_Bilbonotus sp_s053$	Gn_ms_Bilbonotus sp_s053
    1$_NO_HIGHERTAXON$Gn_ms_Cailloumiris austera$	Gn_ms_Cailloumiris austera
    5$_NO_HIGHERTAXON$Gn_ms_Cailloumiris gressitae$	Gn_ms_Cailloumiris gressitae
   12$_NO_HIGHERTAXON$Gn_ms_Cailloumiris ms knc07$	Gn_ms_Cailloumiris ms knc07
    1$_NO_HIGHERTAXON$Gn_ms_Cailloumiris ms_k31$	Gn_ms_Cailloumiris ms_k31
    6$_NO_HIGHERTAXON$Gn_ms_Cailloumiris ms_knc03$	Gn_ms_Cailloumiris ms_knc03
    8$_NO_HIGHERTAXON$Gn_ms_Cailloumiris ms_kraussi$	Gn_ms_Cailloumiris ms_kraussi
   16$_NO_HIGHERTAXON$Gn_ms_Cailloumiris rubrimaculatus$	Gn_ms_Cailloumiris rubrimaculatus
   29$_NO_HIGHERTAXON$Gn_ms_Cailloumiris sanguineus$	Gn_ms_Cailloumiris sanguineus
    1$_NO_HIGHERTAXON$Gn_ms_Callubri sp_ms_wigleyana$	Gn_ms_Callubri sp_ms_wigleyana
   23$_NO_HIGHERTAXON$Gn_ms_Carphodemas sp_wa0909msp193$	Gn_ms_Carphodemas sp_wa0909msp193
    2$_NO_HIGHERTAXON$Gn_ms_Diamantina sp_ms_cantrelli$	Gn_ms_Diamantina sp_ms_cantrelli
    1$_NO_HIGHERTAXON$Gn_ms_Diamantina sp_ms_houstoni$	Gn_ms_Diamantina sp_ms_houstoni
    1$_NO_HIGHERTAXON$Gn_ms_Diamantina sp_ms_monteithi$	Gn_ms_Diamantina sp_ms_monteithi
    3$_NO_HIGHERTAXON$Gn_ms_Falcum ms_austera$	Gn_ms_Falcum ms_austera
   11$_NO_HIGHERTAXON$Gn_ms_Falcum sp_ms_gagneis$	Gn_ms_Falcum sp_ms_gagneis
    4$_NO_HIGHERTAXON$Gn_ms_Falcum sp_ms_kaindiensis$	Gn_ms_Falcum sp_ms_kaindiensis
    9$_NO_HIGHERTAXON$Gn_ms_Flectotheca sp_anouk2.004$	Gn_ms_Flectotheca sp_anouk2.004
  118$_NO_HIGHERTAXON$Gn_ms_Flectotheca sp_wa0909msp100$	Gn_ms_Flectotheca sp_wa0909msp100
    7$_NO_HIGHERTAXON$Gn_ms_Galaxiamiris sp_anouk18.02$	Gn_ms_Galaxiamiris sp_anouk18.02
    5$_NO_HIGHERTAXON$Gn_ms_Granitohyoidea sp_anouk2.005$	Gn_ms_Granitohyoidea sp_anouk2.005
   14$_NO_HIGHERTAXON$Gn_ms_Granitohyoidea sp_anouk4.014$	Gn_ms_Granitohyoidea sp_anouk4.014
  116$_NO_HIGHERTAXON$Gn_ms_Granitohyoidea sp_wa0909msp119$	Gn_ms_Granitohyoidea sp_wa0909msp119
    7$_NO_HIGHERTAXON$Gn_ms_Grevilleamiris sp_ms_lamingtoni$	Gn_ms_Grevilleamiris sp_ms_lamingtoni
    7$_NO_HIGHERTAXON$Gn_ms_Houtoniella sp$	Gn_ms_Houtoniella sp
    1$_NO_HIGHERTAXON$Gn_ms_Houtoniella sp_ms_bullita$	Gn_ms_Houtoniella sp_ms_bullita
    5$_NO_HIGHERTAXON$Gn_ms_Houtoniella sp_ms_houstoni$	Gn_ms_Houtoniella sp_ms_houstoni
    2$_NO_HIGHERTAXON$Gn_ms_Houtoniella sp_ms_microalba$	Gn_ms_Houtoniella sp_ms_microalba
   16$_NO_HIGHERTAXON$Gn_ms_Irymplea sp$	Gn_ms_Irymplea sp
    1$_NO_HIGHERTAXON$Gn_ms_Irymplea sp_ms_armaroo$	Gn_ms_Irymplea sp_ms_armaroo
    3$_NO_HIGHERTAXON$Gn_ms_Irymplea sp_ms_borealis$	Gn_ms_Irymplea sp_ms_borealis
    1$_NO_HIGHERTAXON$Gn_ms_Irymplea sp_ms_darwini$	Gn_ms_Irymplea sp_ms_darwini
    1$_NO_HIGHERTAXON$Gn_ms_Irymplea sp_ms_malipatili$	Gn_ms_Irymplea sp_ms_malipatili
    7$_NO_HIGHERTAXON$Gn_ms_Irymplea sp_ms_nebiossi$	Gn_ms_Irymplea sp_ms_nebiossi
  100$_NO_HIGHERTAXON$Gn_ms_Kikkocoris sp_anouk20.013$	Gn_ms_Kikkocoris sp_anouk20.013
    7$_NO_HIGHERTAXON$Gn_ms_Ladasimiris sp_bbcre11msp034$	Gn_ms_Ladasimiris sp_bbcre11msp034
    9$_NO_HIGHERTAXON$Gn_ms_Ladasimiris sp_wa0909msp202$	Gn_ms_Ladasimiris sp_wa0909msp202
    8$_NO_HIGHERTAXON$Gn_ms_Maralinga sp$	Gn_ms_Maralinga sp
    3$_NO_HIGHERTAXON$Gn_ms_Maralinga sp_ms_casuarinae$	Gn_ms_Maralinga sp_ms_casuarinae
   12$_NO_HIGHERTAXON$Gn_ms_Maralinga sp_ms_striata$	Gn_ms_Maralinga sp_ms_striata
    2$_NO_HIGHERTAXON$Gn_ms_Monteithophorus sp$	Gn_ms_Monteithophorus sp
    1$_NO_HIGHERTAXON$Gn_ms_Monteithophorus sp_ms_auranticus$	Gn_ms_Monteithophorus sp_ms_auranticus
    1$_NO_HIGHERTAXON$Gn_ms_Monteithophorus sp_ms_caloundrae$	Gn_ms_Monteithophorus sp_ms_caloundrae
    1$_NO_HIGHERTAXON$Gn_ms_Monteithophorus sp_ms_exleyi$	Gn_ms_Monteithophorus sp_ms_exleyi
    1$_NO_HIGHERTAXON$Gn_ms_Monteithophorus sp_ms_vestjens$	Gn_ms_Monteithophorus sp_ms_vestjens
    5$_NO_HIGHERTAXON$Gn_ms_Mundi sp$	Gn_ms_Mundi sp
    1$_NO_HIGHERTAXON$Gn_ms_Mundi sp_ms_gilli$	Gn_ms_Mundi sp_ms_gilli
    1$_NO_HIGHERTAXON$Gn_ms_Myodochophorus sp_ms_yorki$	Gn_ms_Myodochophorus sp_ms_yorki
    1$_NO_HIGHERTAXON$Gn_ms_Myrmeciamia sp_ms_aitkeni$	Gn_ms_Myrmeciamia sp_ms_aitkeni
    1$_NO_HIGHERTAXON$Gn_ms_Myrmeciamia sp_ms_arida$	Gn_ms_Myrmeciamia sp_ms_arida
   11$_NO_HIGHERTAXON$Gn_ms_Myrmeciocoris sp$	Gn_ms_Myrmeciocoris sp
    5$_NO_HIGHERTAXON$Gn_ms_Myrmeciocoris sp_ms_gingini$	Gn_ms_Myrmeciocoris sp_ms_gingini
    1$_NO_HIGHERTAXON$Gn_ms_Myrmeciocoris sp_ms_minor$	Gn_ms_Myrmeciocoris sp_ms_minor
   53$_NO_HIGHERTAXON$Gn_ms_Naranjakotta sp_ms_hakeaphila$	Gn_ms_Naranjakotta sp_ms_hakeaphila
   22$_NO_HIGHERTAXON$Gn_ms_Naranjakotta sp_ms_keraudrenia$	Gn_ms_Naranjakotta sp_ms_keraudrenia
   60$_NO_HIGHERTAXON$Gn_ms_Naranjakotta sp_ms_sidnica$	Gn_ms_Naranjakotta sp_ms_sidnica
   41$_NO_HIGHERTAXON$Gn_ms_Naranjakotta sp_ms_watheroo$	Gn_ms_Naranjakotta sp_ms_watheroo
   21$_NO_HIGHERTAXON$Gn_ms_Neocallitropsella sp_ms_madeleineae$	Gn_ms_Neocallitropsella sp_ms_madeleineae
    5$_NO_HIGHERTAXON$Gn_ms_Neoepimixia sp_ms_albimons$	Gn_ms_Neoepimixia sp_ms_albimons
    7$_NO_HIGHERTAXON$Gn_ms_Neoepimixia sp_ms_kimberley$	Gn_ms_Neoepimixia sp_ms_kimberley
    1$_NO_HIGHERTAXON$Gn_ms_Neowoodwardiola sp_ms_tanseyi$	Gn_ms_Neowoodwardiola sp_ms_tanseyi
    5$_NO_HIGHERTAXON$Gn_ms_Nerubia sp_m2$	Gn_ms_Nerubia sp_m2
    1$_NO_HIGHERTAXON$Gn_ms_Nike sp_ms_xerata$	Gn_ms_Nike sp_ms_xerata
    2$_NO_HIGHERTAXON$Gn_ms_Ommatodemella sp_ms_telstra$	Gn_ms_Ommatodemella sp_ms_telstra
    4$_NO_HIGHERTAXON$Gn_ms_Opera sp$	Gn_ms_Opera sp
    3$_NO_HIGHERTAXON$Gn_ms_Opera sp_ms_bellisima$	Gn_ms_Opera sp_ms_bellisima
    4$_NO_HIGHERTAXON$Gn_ms_Opera sp_ms_commoni$	Gn_ms_Opera sp_ms_commoni
    1$_NO_HIGHERTAXON$Gn_ms_Opera sp_ms_fasciatus$	Gn_ms_Opera sp_ms_fasciatus
    3$_NO_HIGHERTAXON$Gn_ms_Opera sp_ms_punctata$	Gn_ms_Opera sp_ms_punctata
    1$_NO_HIGHERTAXON$Gn_ms_Opera sp_ms_rubricosus$	Gn_ms_Opera sp_ms_rubricosus
    3$_NO_HIGHERTAXON$Gn_ms_Passochloris sp_wa0909msp287$	Gn_ms_Passochloris sp_wa0909msp287
    1$_NO_HIGHERTAXON$Gn_ms_Pheramenocoris sp_ms_pilbarata$	Gn_ms_Pheramenocoris sp_ms_pilbarata
    1$_NO_HIGHERTAXON$Gn_ms_Pseudoformicoides sp_ms_commoni$	Gn_ms_Pseudoformicoides sp_ms_commoni
    5$_NO_HIGHERTAXON$Gn_ms_Pseudomaralinga sp_ms_casuarinophilus$	Gn_ms_Pseudomaralinga sp_ms_casuarinophilus
  127$_NO_HIGHERTAXON$Gn_ms_Rankiniella sp$	Gn_ms_Rankiniella sp
    3$_NO_HIGHERTAXON$Gn_ms_Rankiniella sp_ms_acaciae$	Gn_ms_Rankiniella sp_ms_acaciae
    6$_NO_HIGHERTAXON$Gn_ms_Rankiniella sp_ms_albonotatus$	Gn_ms_Rankiniella sp_ms_albonotatus
    4$_NO_HIGHERTAXON$Gn_ms_Rankiniella sp_ms_flindersi$	Gn_ms_Rankiniella sp_ms_flindersi
    2$_NO_HIGHERTAXON$Gn_ms_Rankiniella sp_ms_gibsoni$	Gn_ms_Rankiniella sp_ms_gibsoni
    1$_NO_HIGHERTAXON$Gn_ms_Rankiniella sp_ms_houstoni$	Gn_ms_Rankiniella sp_ms_houstoni
    1$_NO_HIGHERTAXON$Gn_ms_Rankiniella sp_ms_maree$	Gn_ms_Rankiniella sp_ms_maree
    2$_NO_HIGHERTAXON$Gn_ms_Rankiniella sp_ms_nigranotum$	Gn_ms_Rankiniella sp_ms_nigranotum
    1$_NO_HIGHERTAXON$Gn_ms_Rankiniella sp_ms_rosei$	Gn_ms_Rankiniella sp_ms_rosei
    1$_NO_HIGHERTAXON$Gn_ms_Rankiniella sp_ms_stuarti$	Gn_ms_Rankiniella sp_ms_stuarti
    2$_NO_HIGHERTAXON$Gn_ms_Rankiniella sp_ms_tindalei$	Gn_ms_Rankiniella sp_ms_tindalei
   28$_NO_HIGHERTAXON$Gn_ms_Sophocoris sp$	Gn_ms_Sophocoris sp
    1$_NO_HIGHERTAXON$Gn_ms_Teratotibiacoris sp_ms_eowilsoni$	Gn_ms_Teratotibiacoris sp_ms_eowilsoni
    1$_NO_HIGHERTAXON$Gn_ms_Tumidocoris sp$	Gn_ms_Tumidocoris sp
    1$_NO_HIGHERTAXON$Gn_ms_Xerocoris sp_ms_woodwardi$	Gn_ms_Xerocoris sp_ms_woodwardi
    2$_NO_HIGHERTAXON$Gn_ms_Xnoudimiris sp_ms_rubracephalus$	Gn_ms_Xnoudimiris sp_ms_rubracephalus
    2$_NO_HIGHERTAXON$Gn_nov_01 sp.$	Gn_nov_01 sp.
    2$_NO_HIGHERTAXON$Gn_nov_01 sp_01$	Gn_nov_01 sp_01
    2$_NO_HIGHERTAXON$Gn_nov_01 sp_02$	Gn_nov_01 sp_02
    1$_NO_HIGHERTAXON$Gn_nov_01 sp_03$	Gn_nov_01 sp_03
    1$_NO_HIGHERTAXON$Gn_nov_01 sp_04$	Gn_nov_01 sp_04
   20$_NO_HIGHERTAXON$Gn_nov_01 sp_05$	Gn_nov_01 sp_05
   26$_NO_HIGHERTAXON$Gn_nov_01 sp_ms_aust_001$	Gn_nov_01 sp_ms_aust_001
    4$_NO_HIGHERTAXON$Gn_nov_01 sp_ms_aust_002_012$	Gn_nov_01 sp_ms_aust_002_012
    7$_NO_HIGHERTAXON$Gn_nov_01 sp_ms_aust_003_002$	Gn_nov_01 sp_ms_aust_003_002
   25$_NO_HIGHERTAXON$Gn_nov_01 sp_ms_aust_004_008$	Gn_nov_01 sp_ms_aust_004_008
   10$_NO_HIGHERTAXON$Gn_nov_01 sp_ms_aust_005_004$	Gn_nov_01 sp_ms_aust_005_004
    2$_NO_HIGHERTAXON$Gn_nov_01 sp_ms_aust_006$	Gn_nov_01 sp_ms_aust_006
   19$_NO_HIGHERTAXON$Gn_nov_01 sp_ms_aust_007$	Gn_nov_01 sp_ms_aust_007
    2$_NO_HIGHERTAXON$Gn_nov_01 sp_ms_aust_008_msp023$	Gn_nov_01 sp_ms_aust_008_msp023
    2$_NO_HIGHERTAXON$Gn_nov_01 sp_ms_aust_009$	Gn_nov_01 sp_ms_aust_009
    1$_NO_HIGHERTAXON$Gn_nov_02 sp_01$	Gn_nov_02 sp_01
    1$_NO_HIGHERTAXON$Gn_nr_Malandiola sp_ms_ernestgiles$	Gn_nr_Malandiola sp_ms_ernestgiles
    5$_NO_HIGHERTAXON$Gn_nr_Nectocader sp$	Gn_nr_Nectocader sp
    1$_NO_HIGHERTAXON$Gonystus nasutus$	Gonystus sp_ms_nasutus
  437$_NO_HIGHERTAXON$Goodeniaphila cassisi$	Goodeniaphila sp_ms_cassisi
  100$_NO_HIGHERTAXON$Goodeniaphila schuhi$	Goodeniaphila sp_ms_schuhi
    3$_NO_HIGHERTAXON$Goondnomdanepa weiri$	Goondnomdanepa sp_ms_weiri
  109$_NO_HIGHERTAXON$Grandivesica agnew$	Grandivesica sp_ms_agnew
   30$_NO_HIGHERTAXON$Grandivesica aurea$	Grandivesica sp_ms_aurea
  225$_NO_HIGHERTAXON$Grandivesica cassisi$	Grandivesica sp_ms_cassisi
   27$_NO_HIGHERTAXON$Grandivesica kadji$	Grandivesica sp_ms_kadji
   64$_NO_HIGHERTAXON$Grandivesica pilbara$	Grandivesica sp_ms_pilbara
    2$_NO_HIGHERTAXON$Grossiana sp_1$	Grossiana sp_1
    5$_NO_HIGHERTAXON$Gulacapsus australiensis$	Gulacapsus sp_ms_australiensis
   14$_NO_HIGHERTAXON$Gulacapsus novoguinensis$	Gulacapsus sp_ms_novoguinensis
    3$_NO_HIGHERTAXON$Gulacapsus sp.$	Gulacapsus sp.
    1$_NO_HIGHERTAXON$Gunadhya rubrofasciata$	Gunadhya sp_ms_rubrofasciata
    1$_NO_HIGHERTAXON$Gymnotingis serrulata$	Gymnotingis sp_ms_serrulata
    1$_NO_HIGHERTAXON$Gymnotingis sp.$	Gymnotingis sp.
   54$_NO_HIGHERTAXON$Gyrophallus darwinensis$	Gyrophallus sp_ms_darwinensis
   10$_NO_HIGHERTAXON$Gyrophallus donggali$	Gyrophallus sp_ms_donggali
   18$_NO_HIGHERTAXON$Gyrophallus forrestii$	Gyrophallus sp_ms_forrestii
    1$_NO_HIGHERTAXON$Gyrophallus karara$	Gyrophallus sp_ms_karara
    9$_NO_HIGHERTAXON$Gyrophallus lasseteri$	Gyrophallus sp_ms_lasseteri
    2$_NO_HIGHERTAXON$Gyrophallus lochada$	Gyrophallus sp_ms_lochada
   24$_NO_HIGHERTAXON$Gyrophallus pantonii$	Gyrophallus sp_ms_pantonii
   65$_NO_HIGHERTAXON$Gyrophallus symondsae$	Gyrophallus sp_ms_symondsae
    1$_NO_HIGHERTAXON$Hallodapus fasciatus$	Hallodapus sp_ms_fasciatus
    6$_NO_HIGHERTAXON$Hallodapus ravenar$	Hallodapus sp_ms_ravenar
  224$_NO_HIGHERTAXON$Halophylus atriplicis$	Halophylus sp_ms_atriplicis
  144$_NO_HIGHERTAXON$Halophylus chenopodos$	Halophylus sp_ms_chenopodos
  106$_NO_HIGHERTAXON$Halophylus maireani$	Halophylus sp_ms_maireani
   63$_NO_HIGHERTAXON$Halophylus rhagodii$	Halophylus sp_ms_rhagodii
  136$_NO_HIGHERTAXON$Halophylus salsoli$	Halophylus sp_ms_salsoli
  269$_NO_HIGHERTAXON$Halophylus tecticornii$	Halophylus sp_ms_tecticornii
    2$_NO_HIGHERTAXON$Halticus minutus$	Halticus sp_ms_minutus
   20$_NO_HIGHERTAXON$Harpagophylus agnew$	Harpagophylus sp_ms_agnew
   10$_NO_HIGHERTAXON$Harpagophylus calytrix$	Harpagophylus sp_ms_calytrix
    8$_NO_HIGHERTAXON$Harpagophylus scholtzii$	Harpagophylus sp_ms_scholtzii
   22$_NO_HIGHERTAXON$Harpagophylus sp.$	Harpagophylus sp.
   24$_NO_HIGHERTAXON$Harpagophylus thryptomeni$	Harpagophylus sp_ms_thryptomeni
   64$_NO_HIGHERTAXON$Harpagophylus verticordii$	Harpagophylus sp_ms_verticordii
    2$_NO_HIGHERTAXON$Harveycapsus dimorpha$	Harveycapsus sp_ms_dimorpha
    1$_NO_HIGHERTAXON$Hebrolethaeus sp_norfolk_island$	Hebrolethaeus sp_norfolk_island
   92$_NO_HIGHERTAXON$Hekista laudator$	Hekista sp_ms_laudator
    1$_NO_HIGHERTAXON$Helopeltis bradyi$	Helopeltis sp_ms_bradyi
    9$_NO_HIGHERTAXON$Helopeltis cinchonae$	Helopeltis sp_ms_cinchonae
   29$_NO_HIGHERTAXON$Helopeltis clavifer$	Helopeltis sp_ms_clavifer
    2$_NO_HIGHERTAXON$Helopeltis fasciaticollis$	Helopeltis sp_ms_fasciaticollis
    3$_NO_HIGHERTAXON$Helopeltis pernicalis$	Helopeltis sp_ms_pernicalis
   25$_NO_HIGHERTAXON$Helopeltis sp.$	Helopeltis sp.
    8$_NO_HIGHERTAXON$Helopeltis theviora$	Helopeltis sp_ms_theviora
    1$_NO_HIGHERTAXON$Henicocoris monteithi$	Henicocoris sp_ms_monteithi
    8$_NO_HIGHERTAXON$Hillieria sp_n_sp_1$	Hillieria sp_n_sp_1
   56$_NO_HIGHERTAXON$Hypseloecus amyemi$	Hypseloecus sp_ms_amyemi
   98$_NO_HIGHERTAXON$Hypseloecus amyemicola$	Hypseloecus sp_ms_amyemicola
   36$_NO_HIGHERTAXON$Hypseloecus amyemopsis$	Hypseloecus sp_ms_amyemopsis
   26$_NO_HIGHERTAXON$Hypseloecus grossi$	Hypseloecus sp_ms_grossi
  152$_NO_HIGHERTAXON$Hypseloecus lysiani$	Hypseloecus sp_ms_lysiani
   64$_NO_HIGHERTAXON$Hypseloecus metamyemi$	Hypseloecus sp_ms_metamyemi
    4$_NO_HIGHERTAXON$Hypseloecus morobe$	Hypseloecus sp_ms_morobe
  142$_NO_HIGHERTAXON$Hypseloecus neoamyemi$	Hypseloecus sp_ms_neoamyemi
  104$_NO_HIGHERTAXON$Hypseloecus paramyemi$	Hypseloecus sp_ms_paramyemi
    7$_NO_HIGHERTAXON$Hypseloecus schuhi$	Hypseloecus sp_ms_schuhi
    3$_NO_HIGHERTAXON$Hypseloecus sp.$	Hypseloecus sp.
    2$_NO_HIGHERTAXON$Hypsipyrgias euphues$	Hypsipyrgias sp_ms_euphues
   21$_NO_HIGHERTAXON$Hypsipyrgias telamonides$	Hypsipyrgias sp_ms_telamonides
    1$_NO_HIGHERTAXON$Imogen sp.$	Imogen sp.
   43$_NO_HIGHERTAXON$Inoma arrernte$	Inoma sp_ms_arrernte
    5$_NO_HIGHERTAXON$Inoma breviseta$	Inoma sp_ms_breviseta
  164$_NO_HIGHERTAXON$Inoma fuscata$	Inoma sp_ms_fuscata
    4$_NO_HIGHERTAXON$Inoma innamincka$	Inoma sp_ms_innamincka
   23$_NO_HIGHERTAXON$Inoma kalbarri$	Inoma sp_ms_kalbarri
   62$_NO_HIGHERTAXON$Inoma multispinosa$	Inoma sp_ms_multispinosa
  230$_NO_HIGHERTAXON$Inoma silveirae$	Inoma sp_ms_silveirae
    1$_NO_HIGHERTAXON$Inoma solusa$	Inoma sp_ms_solusa
  121$_NO_HIGHERTAXON$Inoma sp$	Inoma sp
  404$_NO_HIGHERTAXON$Inoma sp_02$	Inoma sp_02
   11$_NO_HIGHERTAXON$Inoma sp_04$	Inoma sp_04
    1$_NO_HIGHERTAXON$Inoma sp_ms_badimia$	Inoma sp_ms_badimia
    3$_NO_HIGHERTAXON$Inoma sp_ms_karijini$	Inoma sp_ms_karijini
   18$_NO_HIGHERTAXON$Inoma stysi$	Inoma sp_ms_stysi
   25$_NO_HIGHERTAXON$Inonemia mussiva$	Inonemia sp_ms_mussiva
    2$_NO_HIGHERTAXON$Inonemia sp_ms_exmouth$	Inonemia sp_ms_exmouth
    1$_NO_HIGHERTAXON$Iphicrates sp$	Iphicrates sp
   16$_NO_HIGHERTAXON$Irianocoris australicus$	Irianocoris sp_ms_australicus
    1$_NO_HIGHERTAXON$Irianocoris carbine n. sp$	Irianocoris sp_carbine_n_sp
    4$_NO_HIGHERTAXON$Irianocoris carvalhoi n.sp$	Irianocoris sp_carvalhoi_nsp
    3$_NO_HIGHERTAXON$Irianocoris italae$	Irianocoris sp_ms_italae
    3$_NO_HIGHERTAXON$Irianocoris schuhi n. sp.$	Irianocoris sp_schuhi_n_sp
   34$_NO_HIGHERTAXON$Ischnotingis fasciata$	Ischnotingis sp_ms_fasciata
   12$_NO_HIGHERTAXON$Ischnotingis sp$	Ischnotingis sp
    2$_NO_HIGHERTAXON$Ischnotingis sp_ms_parawirra$	Ischnotingis sp_ms_parawirra
    4$_NO_HIGHERTAXON$Jimia bimaculata$	Jimia sp_ms_bimaculata
    3$_NO_HIGHERTAXON$Jiwarli exmaculae$	Jiwarli sp_ms_exmaculae
  100$_NO_HIGHERTAXON$Jiwarli heliotropium$	Jiwarli sp_ms_heliotropium
   37$_NO_HIGHERTAXON$Jiwarli ptilotus$	Jiwarli sp_ms_ptilotus
   86$_NO_HIGHERTAXON$Jiwarli solanum$	Jiwarli sp_ms_solanum
   10$_NO_HIGHERTAXON$Johnstonsonius phalarosus$	Johnstonsonius sp_ms_phalarosus
    9$_NO_HIGHERTAXON$Kalkadoona confinis$	Kalkadoona sp_ms_confinis
    3$_NO_HIGHERTAXON$Kalkadoona cooperi$	Kalkadoona sp_ms_cooperi
    1$_NO_HIGHERTAXON$Kalkadoona pallida$	Kalkadoona sp_ms_pallida
   11$_NO_HIGHERTAXON$Kirkaldyella adunca$	Kirkaldyella sp_ms_adunca
    5$_NO_HIGHERTAXON$Kirkaldyella anasillosi$	Kirkaldyella sp_ms_anasillosi
   12$_NO_HIGHERTAXON$Kirkaldyella argoantyx$	Kirkaldyella sp_ms_argoantyx
   18$_NO_HIGHERTAXON$Kirkaldyella boweri$	Kirkaldyella sp_ms_boweri
    7$_NO_HIGHERTAXON$Kirkaldyella carotarhani$	Kirkaldyella sp_ms_carotarhani
    1$_NO_HIGHERTAXON$Kirkaldyella mcalpinei$	Kirkaldyella sp_ms_mcalpinei
    1$_NO_HIGHERTAXON$Kirkaldyella mcmillani$	Kirkaldyella sp_ms_mcmillani
    3$_NO_HIGHERTAXON$Kirkaldyella ngarkati$	Kirkaldyella sp_ms_ngarkati
    1$_NO_HIGHERTAXON$Kirkaldyella notaurantia$	Kirkaldyella sp_ms_notaurantia
    2$_NO_HIGHERTAXON$Kirkaldyella ortholata$	Kirkaldyella sp_ms_ortholata
   11$_NO_HIGHERTAXON$Kirkaldyella pilosa$	Kirkaldyella sp_ms_pilosa
   44$_NO_HIGHERTAXON$Kirkaldyella rugosa$	Kirkaldyella sp_ms_rugosa
   30$_NO_HIGHERTAXON$Kirkaldyella schuhi$	Kirkaldyella sp_ms_schuhi
   37$_NO_HIGHERTAXON$Kirkaldyella sp.$	Kirkaldyella sp.
    2$_NO_HIGHERTAXON$Kundakimuka carvalhoi$	Kundakimuka sp_ms_carvalhoi
    7$_NO_HIGHERTAXON$Kundakimuka queenslandica$	Kundakimuka sp_ms_queenslandica
    1$_NO_HIGHERTAXON$Lachnophoroides frerei$	Lachnophoroides sp_ms_frerei
    1$_NO_HIGHERTAXON$Lachnophoroides thompsoni$	Lachnophoroides sp_ms_thompsoni
    3$_NO_HIGHERTAXON$Larotingis sp$	Larotingis sp
    9$_NO_HIGHERTAXON$Laryngodus australiae$	Laryngodus sp_ms_australiae
   25$_NO_HIGHERTAXON$Laryngodus cervantes$	Laryngodus sp_ms_cervantes
   34$_NO_HIGHERTAXON$Laryngodus luteomaculatus$	Laryngodus sp_ms_luteomaculatus
    4$_NO_HIGHERTAXON$Lasiacantha adamah$	Lasiacantha sp_ms_adamah
  223$_NO_HIGHERTAXON$Lasiacantha aureolus$	Lasiacantha sp_ms_aureolus
   16$_NO_HIGHERTAXON$Lasiacantha caneriverensis$	Lasiacantha sp_ms_caneriverensis
    9$_NO_HIGHERTAXON$Lasiacantha darwini$	Lasiacantha sp_ms_darwini
  107$_NO_HIGHERTAXON$Lasiacantha discordis$	Lasiacantha sp_ms_discordis
    2$_NO_HIGHERTAXON$Lasiacantha dysmikos$	Lasiacantha sp_ms_dysmikos
   15$_NO_HIGHERTAXON$Lasiacantha ephemera$	Lasiacantha sp_ms_ephemera
   12$_NO_HIGHERTAXON$Lasiacantha eremophila$	Lasiacantha sp_ms_eremophila
    4$_NO_HIGHERTAXON$Lasiacantha gingera$	Lasiacantha sp_ms_gingera
   13$_NO_HIGHERTAXON$Lasiacantha graminicola$	Lasiacantha sp_ms_graminicola
   12$_NO_HIGHERTAXON$Lasiacantha inaquosa$	Lasiacantha sp_ms_inaquosa
    2$_NO_HIGHERTAXON$Lasiacantha kosciuszko$	Lasiacantha sp_ms_kosciuszko
    1$_NO_HIGHERTAXON$Lasiacantha leai$	Lasiacantha sp_ms_leai
   61$_NO_HIGHERTAXON$Lasiacantha luritja$	Lasiacantha sp_ms_luritja
    5$_NO_HIGHERTAXON$Lasiacantha meedo$	Lasiacantha sp_ms_meedo
   10$_NO_HIGHERTAXON$Lasiacantha ningaloo$	Lasiacantha sp_ms_ningaloo
    1$_NO_HIGHERTAXON$Lasiacantha nipha$	Lasiacantha sp_ms_nipha
   16$_NO_HIGHERTAXON$Lasiacantha pilbara$	Lasiacantha sp_ms_pilbara
    2$_NO_HIGHERTAXON$Lasiacantha quilpie$	Lasiacantha sp_ms_quilpie
   12$_NO_HIGHERTAXON$Lasiacantha serraseta$	Lasiacantha sp_ms_serraseta
    6$_NO_HIGHERTAXON$Lasiacantha spinosa$	Lasiacantha sp_ms_spinosa
    1$_NO_HIGHERTAXON$Lasiacantha vittata$	Lasiacantha sp_ms_vittata
    1$_NO_HIGHERTAXON$Lasiacantha windorah$	Lasiacantha sp_ms_windorah
    7$_NO_HIGHERTAXON$Lasiolabops cosmopolites$	Lasiolabops sp_ms_cosmopolites
    6$_NO_HIGHERTAXON$Lasiolabops irianicus$	Lasiolabops sp_ms_irianicus
    1$_NO_HIGHERTAXON$Lasiolabops kokoda$	Lasiolabops sp_ms_kokoda
    1$_NO_HIGHERTAXON$Lasiolabops sp.$	Lasiolabops sp.
   83$_NO_HIGHERTAXON$Lattinova jacki$	Lattinova sp_ms_jacki
    3$_NO_HIGHERTAXON$Lepidophylus guttatus$	Lepidophylus sp_ms_guttatus
    2$_NO_HIGHERTAXON$Leptocoris sp$	Leptocoris sp
    1$_NO_HIGHERTAXON$Leptocorisa acuta$	Leptocorisa sp_ms_acuta
    1$_NO_HIGHERTAXON$Leptopharsa elegans$	Leptopharsa sp_ms_elegans
   51$_NO_HIGHERTAXON$Leptoypha anceps$	Leptoypha sp_ms_anceps
   11$_NO_HIGHERTAXON$Lepturga magnifica$	Lepturga sp_ms_magnifica
    1$_NO_HIGHERTAXON$Leucophoroptera cavenda$	Leucophoroptera sp_ms_cavenda
    1$_NO_HIGHERTAXON$Leucophoroptera gloriosa$	Leucophoroptera sp_ms_gloriosa
   10$_NO_HIGHERTAXON$Leucophoroptera kangarooina$	Leucophoroptera sp_ms_kangarooina
   54$_NO_HIGHERTAXON$Leucophoroptera quadrimaculata$	Leucophoroptera sp_ms_quadrimaculata
    8$_NO_HIGHERTAXON$Leucophoroptera sp.$	Leucophoroptera sp.
  150$_NO_HIGHERTAXON$Linacoris sp_ms_connori$	Linacoris sp_ms_connori
  150$_NO_HIGHERTAXON$Linacoris sp_ms_incognita$	Linacoris sp_ms_incognita
   77$_NO_HIGHERTAXON$Linacoris sp_ms_malayensis$	Linacoris sp_ms_malayensis
    7$_NO_HIGHERTAXON$Linacoris sp_ms_pakan$	Linacoris sp_ms_pakan
   19$_NO_HIGHERTAXON$Linacoris sp_ms_pilosus$	Linacoris sp_ms_pilosus
   21$_NO_HIGHERTAXON$Linacoris sp_ms_quoinensis$	Linacoris sp_ms_quoinensis
    9$_NO_HIGHERTAXON$Linacoris sp_ms_schuhi$	Linacoris sp_ms_schuhi
  838$_NO_HIGHERTAXON$Linacoris sp_ms_solomonensis$	Linacoris sp_ms_solomonensis
 1143$_NO_HIGHERTAXON$Linacoris viridescens$	Linacoris sp_ms_viridescens
    1$_NO_HIGHERTAXON$Lisarda rhypara$	Lisarda sp_ms_rhypara
    1$_NO_HIGHERTAXON$Lisarda sp.$	Lisarda sp.
   14$_NO_HIGHERTAXON$Lopidea sp.$	Lopidea sp.
    1$_NO_HIGHERTAXON$Lopus decolor$	Lopus sp_ms_decolor
    1$_NO_HIGHERTAXON$Lygus muiri$	Lygus sp_ms_muiri
    1$_NO_HIGHERTAXON$Lygus pacificus$	Lygus sp_ms_pacificus
   29$_NO_HIGHERTAXON$Macrocarenoides scutellatus$	Macrocarenoides sp_ms_scutellatus
    8$_NO_HIGHERTAXON$Macrocarenoides sp_1$	Macrocarenoides sp_1
    6$_NO_HIGHERTAXON$Macrocarenus acuminatus$	Macrocarenus sp_ms_acuminatus
   44$_NO_HIGHERTAXON$Maculiphylus eremophilae$	Maculiphylus sp_ms_eremophilae
    1$_NO_HIGHERTAXON$Maevius indecorus$	Maevius sp_ms_indecorus
    5$_NO_HIGHERTAXON$Malandiola acares$	Malandiola sp_ms_acares
  180$_NO_HIGHERTAXON$Malandiola semota$	Malandiola sp_ms_semota
   41$_NO_HIGHERTAXON$Malandiola similis$	Malandiola sp_ms_similis
   48$_NO_HIGHERTAXON$Malandiola sp$	Malandiola sp
   34$_NO_HIGHERTAXON$Malandiola sp_02$	Malandiola sp_02
   57$_NO_HIGHERTAXON$Malandiola sp_03$	Malandiola sp_03
   56$_NO_HIGHERTAXON$Malandiola sp_04$	Malandiola sp_04
   42$_NO_HIGHERTAXON$Malandiola sp_04a$	Malandiola sp_04a
   16$_NO_HIGHERTAXON$Malandiola sp_04aa$	Malandiola sp_04aa
   14$_NO_HIGHERTAXON$Malandiola sp_04b$	Malandiola sp_04b
  158$_NO_HIGHERTAXON$Malandiola sp_04bb$	Malandiola sp_04bb
  310$_NO_HIGHERTAXON$Malandiola sp_04c$	Malandiola sp_04c
   17$_NO_HIGHERTAXON$Malandiola sp_05$	Malandiola sp_05
   28$_NO_HIGHERTAXON$Malandiola sp_ms_coomallo$	Malandiola sp_ms_coomallo
    2$_NO_HIGHERTAXON$Malandiola sp_ms_wyndham$	Malandiola sp_ms_wyndham
    1$_NO_HIGHERTAXON$Mansoniella sp.$	Mansoniella sp.
   94$_NO_HIGHERTAXON$Mcateella austera$	Mcateella sp_ms_austera
   30$_NO_HIGHERTAXON$Mcateella coolgardie$	Mcateella sp_ms_coolgardie
  293$_NO_HIGHERTAXON$Mcateella elongata$	Mcateella sp_ms_elongata
  101$_NO_HIGHERTAXON$Mcateella esperancensis$	Mcateella sp_ms_esperancensis
   51$_NO_HIGHERTAXON$Mcateella exocarposa$	Mcateella sp_ms_exocarposa
   71$_NO_HIGHERTAXON$Mcateella gibber$	Mcateella sp_ms_gibber
  162$_NO_HIGHERTAXON$Mcateella interioris$	Mcateella sp_ms_interioris
  134$_NO_HIGHERTAXON$Mcateella kwoki$	Mcateella sp_ms_kwoki
   60$_NO_HIGHERTAXON$Mcateella reidi$	Mcateella sp_ms_reidi
  167$_NO_HIGHERTAXON$Mcateella schuhi$	Mcateella sp_ms_schuhi
   23$_NO_HIGHERTAXON$Mcateella sp$	Mcateella sp
   22$_NO_HIGHERTAXON$Mcateella splendida$	Mcateella sp_ms_splendida
   12$_NO_HIGHERTAXON$Mecopharsa hackeri$	Mecopharsa sp_ms_hackeri
   34$_NO_HIGHERTAXON$Megadrymus aurorae$	Megadrymus sp_ms_aurorae
    1$_NO_HIGHERTAXON$Megadrymus brigalow$	Megadrymus sp_ms_brigalow
    4$_NO_HIGHERTAXON$Megadrymus brunneus$	Megadrymus sp_ms_brunneus
    2$_NO_HIGHERTAXON$Megadrymus capeyorkensis$	Megadrymus sp_ms_capeyorkensis
   18$_NO_HIGHERTAXON$Megadrymus kakadu$	Megadrymus sp_ms_kakadu
    4$_NO_HIGHERTAXON$Megadrymus refugiensis$	Megadrymus sp_ms_refugiensis
    2$_NO_HIGHERTAXON$Megadrymus tenuicornis$	Megadrymus sp_ms_tenuicornis
   25$_NO_HIGHERTAXON$Megadrymus terraereginae$	Megadrymus sp_ms_terraereginae
    3$_NO_HIGHERTAXON$Melaleuca sp 102$	Melaleuca sp_102
    9$_NO_HIGHERTAXON$Melaleuca sp 114$	Melaleuca sp_114
    3$_NO_HIGHERTAXON$Melaleuca sp 117$	Melaleuca sp_117
   29$_NO_HIGHERTAXON$Melaleuca sp 118$	Melaleuca sp_118
  475$_NO_HIGHERTAXON$Melaleuca sp 120$	Melaleuca sp_120
   10$_NO_HIGHERTAXON$Melaleuca sp 152$	Melaleuca sp_152
   17$_NO_HIGHERTAXON$Melaleuca sp 167$	Melaleuca sp_167
    5$_NO_HIGHERTAXON$Melaleuca sp 182$	Melaleuca sp_182
   35$_NO_HIGHERTAXON$Melaleuca sp 189$	Melaleuca sp_189
  113$_NO_HIGHERTAXON$Melaleuca sp 207$	Melaleuca sp_207
   36$_NO_HIGHERTAXON$Melaleuca sp 221$	Melaleuca sp_221
  143$_NO_HIGHERTAXON$Melaleuca sp 23$	Melaleuca sp_23
    4$_NO_HIGHERTAXON$Melaleuca sp 239$	Melaleuca sp_239
   70$_NO_HIGHERTAXON$Melaleuca sp 240$	Melaleuca sp_240
    1$_NO_HIGHERTAXON$Melaleuca sp 249$	Melaleuca sp_249
    2$_NO_HIGHERTAXON$Melaleuca sp 251$	Melaleuca sp_251
    6$_NO_HIGHERTAXON$Melaleuca sp 254$	Melaleuca sp_254
  141$_NO_HIGHERTAXON$Melaleuca sp 28$	Melaleuca sp_28
  502$_NO_HIGHERTAXON$Melaleuca sp 3$	Melaleuca sp_3
  172$_NO_HIGHERTAXON$Melaleuca sp 36$	Melaleuca sp_36
   30$_NO_HIGHERTAXON$Melaleuca sp 38$	Melaleuca sp_38
  129$_NO_HIGHERTAXON$Melaleuca sp 40$	Melaleuca sp_40
   36$_NO_HIGHERTAXON$Melaleuca sp 44$	Melaleuca sp_44
   15$_NO_HIGHERTAXON$Melaleuca sp 50$	Melaleuca sp_50
    4$_NO_HIGHERTAXON$Melaleuca sp 56$	Melaleuca sp_56
    9$_NO_HIGHERTAXON$Melaleuca sp 74$	Melaleuca sp_74
   39$_NO_HIGHERTAXON$Melaleuca sp 75$	Melaleuca sp_75
   57$_NO_HIGHERTAXON$Melaleuca sp 9$	Melaleuca sp_9
   22$_NO_HIGHERTAXON$Melaleuca sp 91$	Melaleuca sp_91
  107$_NO_HIGHERTAXON$Melaleuca sp 93$	Melaleuca sp_93
  882$_NO_HIGHERTAXON$Melaleuca sp$	Melaleuca sp
   24$_NO_HIGHERTAXON$Melaleucoides akaina$	Melaleucoides sp_ms_akaina
  186$_NO_HIGHERTAXON$Melaleucoides annae$	Melaleucoides sp_ms_annae
   39$_NO_HIGHERTAXON$Melaleucoides beaufortiae$	Melaleucoides sp_ms_beaufortiae
   57$_NO_HIGHERTAXON$Melaleucoides brevifoliae$	Melaleucoides sp_ms_brevifoliae
  205$_NO_HIGHERTAXON$Melaleucoides cassisi$	Melaleucoides sp_ms_cassisi
    4$_NO_HIGHERTAXON$Melaleucoides castanea$	Melaleucoides sp_ms_castanea
   47$_NO_HIGHERTAXON$Melaleucoides grossi$	Melaleucoides sp_ms_grossi
   49$_NO_HIGHERTAXON$Melaleucoides leuropomae$	Melaleucoides sp_ms_leuropomae
   32$_NO_HIGHERTAXON$Melaleucoides micranthae$	Melaleucoides sp_ms_micranthae
   21$_NO_HIGHERTAXON$Melaleucoides ozzii$	Melaleucoides sp_ms_ozzii
  148$_NO_HIGHERTAXON$Melaleucoides pileanthicola$	Melaleucoides sp_ms_pileanthicola
   13$_NO_HIGHERTAXON$Melaleucoides raphiophyllae$	Melaleucoides sp_ms_raphiophyllae
  120$_NO_HIGHERTAXON$Melaleucoides sheathianae$	Melaleucoides sp_ms_sheathianae
    5$_NO_HIGHERTAXON$Melaleucoides similis$	Melaleucoides sp_ms_similis
   18$_NO_HIGHERTAXON$Melaleucoides sp.$	Melaleucoides sp.
   80$_NO_HIGHERTAXON$Melaleucoides systenae$	Melaleucoides sp_ms_systenae
   70$_NO_HIGHERTAXON$Melaleucoides uncinatae$	Melaleucoides sp_ms_uncinatae
   44$_NO_HIGHERTAXON$Melaleucoides undulatae$	Melaleucoides sp_ms_undulatae
 1012$_NO_HIGHERTAXON$Melaleucoides verticordiae$	Melaleucoides sp_ms_verticordiae
    2$_NO_HIGHERTAXON$Mertila malayensis$	Mertila sp_ms_malayensis
    1$_NO_HIGHERTAXON$Metacanthus sp$	Metacanthus sp
    4$_NO_HIGHERTAXON$Metopocoris asquithi$	Metopocoris sp_ms_asquithi
    1$_NO_HIGHERTAXON$Metopocoris carnarvoni$	Metopocoris sp_ms_carnarvoni
   11$_NO_HIGHERTAXON$Metopocoris cassiae$	Metopocoris sp_ms_cassiae
    4$_NO_HIGHERTAXON$Metopocoris forresti$	Metopocoris sp_ms_forresti
   15$_NO_HIGHERTAXON$Metopocoris joannae$	Metopocoris sp_ms_joannae
    3$_NO_HIGHERTAXON$Metopocoris magenta$	Metopocoris sp_ms_magenta
   13$_NO_HIGHERTAXON$Metopocoris rubrifasciatus$	Metopocoris sp_ms_rubrifasciatus
    3$_NO_HIGHERTAXON$Metopocoris scutata$	Metopocoris sp_ms_scutata
    1$_NO_HIGHERTAXON$Metopocoris uberini$	Metopocoris sp_ms_uberini
    2$_NO_HIGHERTAXON$Micromimetus babelthuapensis$	Micromimetus sp_ms_babelthuapensis
    8$_NO_HIGHERTAXON$Micromimetus dybasi$	Micromimetus sp_ms_dybasi
   11$_NO_HIGHERTAXON$Micromimetus kusaiensis$	Micromimetus sp_ms_kusaiensis
   27$_NO_HIGHERTAXON$Micromimetus newcaledoniaensis$	Micromimetus sp_ms_newcaledoniaensis
   16$_NO_HIGHERTAXON$Micromimetus pacificus$	Micromimetus sp_ms_pacificus
   41$_NO_HIGHERTAXON$Micromimetus pictipes$	Micromimetus sp_ms_pictipes
    7$_NO_HIGHERTAXON$Micromimetus ponapensis$	Micromimetus sp_ms_ponapensis
    5$_NO_HIGHERTAXON$Micromimetus sp_ms_norfolkensis$	Micromimetus sp_ms_norfolkensis
    3$_NO_HIGHERTAXON$Micromimetus sp_ms_similaris$	Micromimetus sp_ms_similaris
    1$_NO_HIGHERTAXON$Micromimetus sp_n_1$	Micromimetus sp_n_1
    8$_NO_HIGHERTAXON$Micromimetus trukensis$	Micromimetus sp_ms_trukensis
    1$_NO_HIGHERTAXON$Microtechnites chrysolepis$	Microtechnites sp_ms_chrysolepis
    4$_NO_HIGHERTAXON$Missanos gulafuscus$	Missanos sp_ms_gulafuscus
    1$_NO_HIGHERTAXON$Moissonia philippinensis$	Moissonia sp_ms_philippinensis
    1$_NO_HIGHERTAXON$Monaloniini sp.$	Monaloniini sp.
   22$_NO_HIGHERTAXON$Monospiniphallus bignoniiflori$	Monospiniphallus sp_ms_bignoniiflori
    1$_NO_HIGHERTAXON$Monospiniphallus namyatovae$	Monospiniphallus sp_ms_namyatovae
    1$_NO_HIGHERTAXON$Monospiniphallus norsemanensis$	Monospiniphallus sp_ms_norsemanensis
    2$_NO_HIGHERTAXON$Monteithophila fijiensis$	Monteithophila sp_ms_fijiensis
   24$_NO_HIGHERTAXON$Monteithophila queenslandana$	Monteithophila sp_ms_queenslandana
    1$_NO_HIGHERTAXON$Montrouzieriellus sp_1$	Montrouzieriellus sp_1
    4$_NO_HIGHERTAXON$Montrouzieriellus turneri$	Montrouzieriellus sp_ms_turneri
    1$_NO_HIGHERTAXON$Morbora schoutedeni$	Morbora sp_ms_schoutedeni
    4$_NO_HIGHERTAXON$Morobea longipes$	Morobea sp_ms_longipes
    3$_NO_HIGHERTAXON$Morobea spectabilis$	Morobea sp_ms_spectabilis
    1$_NO_HIGHERTAXON$Myiomma sp.$	Myiomma sp.
   30$_NO_HIGHERTAXON$Myoporophylus carinatus$	Myoporophylus sp_ms_carinatus
  244$_NO_HIGHERTAXON$Myoporophylus grossi$	Myoporophylus sp_ms_grossi
    3$_NO_HIGHERTAXON$Myrmecoridea gracillima$	Myrmecoridea sp_ms_gracillima
   24$_NO_HIGHERTAXON$Myrmecoridea sp$	Myrmecoridea sp
   43$_NO_HIGHERTAXON$Myrmecoridea sp_ms_azulina$	Myrmecoridea sp_ms_azulina
    5$_NO_HIGHERTAXON$Myrmecoridea sp_ms_brunnea$	Myrmecoridea sp_ms_brunnea
    1$_NO_HIGHERTAXON$Myrmecoridea sp_ms_fasciata$	Myrmecoridea sp_ms_fasciata
    2$_NO_HIGHERTAXON$Myrmecoridea sp_ms_malipatili$	Myrmecoridea sp_ms_malipatili
    1$_NO_HIGHERTAXON$Myrmecoridea sp_ms_ovata$	Myrmecoridea sp_ms_ovata
    2$_NO_HIGHERTAXON$Myrmecoroides carinatus$	Myrmecoroides sp_ms_carinatus
   30$_NO_HIGHERTAXON$Myrmecoroides grossi$	Myrmecoroides sp_ms_grossi
   10$_NO_HIGHERTAXON$Myrmecoroides sp_ms_cassowary$	Myrmecoroides sp_ms_cassowary
    8$_NO_HIGHERTAXON$Myrmecoroides sp_ms_monteithi$	Myrmecoroides sp_ms_monteithi
    8$_NO_HIGHERTAXON$Myrmecoroides sp_ms_rufescens$	Myrmecoroides sp_ms_rufescens
    9$_NO_HIGHERTAXON$Myrtlemiris agnew$	Myrtlemiris sp_ms_agnew
   21$_NO_HIGHERTAXON$Myrtlemiris astartephila$	Myrtlemiris sp_ms_astartephila
   13$_NO_HIGHERTAXON$Myrtlemiris meanarra$	Myrtlemiris sp_ms_meanarra
   51$_NO_HIGHERTAXON$Myrtlemiris newmanensis$	Myrtlemiris sp_ms_newmanensis
  120$_NO_HIGHERTAXON$Myrtlemiris rubrocuneatus$	Myrtlemiris sp_ms_rubrocuneatus
  197$_NO_HIGHERTAXON$Myrtlemiris russulatus$	Myrtlemiris sp_ms_russulatus
    2$_NO_HIGHERTAXON$Myrtlemiris silveirae$	Myrtlemiris sp_ms_silveirae
   66$_NO_HIGHERTAXON$Myrtlemiris tesselatus$	Myrtlemiris sp_ms_tesselatus
  123$_NO_HIGHERTAXON$Myrtlemiris yalgoo$	Myrtlemiris sp_ms_yalgoo
  157$_NO_HIGHERTAXON$Myrtophylus calytrix$	Myrtophylus sp_ms_calytrix
   27$_NO_HIGHERTAXON$Myrtophylus melaleuci$	Myrtophylus sp_ms_melaleuci
    9$_NO_HIGHERTAXON$Myrtophylus micromyrti$	Myrtophylus sp_ms_micromyrti
    1$_NO_HIGHERTAXON$Neacoryphus bicrucis$	Neacoryphus sp_ms_bicrucis
    3$_NO_HIGHERTAXON$Neagenor sp_1$	Neagenor sp_1
    2$_NO_HIGHERTAXON$Neagenor sp_2$	Neagenor sp_2
    3$_NO_HIGHERTAXON$Neagenor spinosus$	Neagenor sp_ms_spinosus
    3$_NO_HIGHERTAXON$Neaitkenia uptoni$	Neaitkenia sp_ms_uptoni
    2$_NO_HIGHERTAXON$Neoleucophoroptera novoirlandense$	Neoleucophoroptera sp_ms_novoirlandense
    3$_NO_HIGHERTAXON$Neoloxops sp_np11$	Neoloxops sp_np11
    1$_NO_HIGHERTAXON$Nesocypselas sp_ms_piperica$	Nesocypselas sp_ms_piperica
   14$_NO_HIGHERTAXON$Nethersia absimilis$	Nethersia sp_ms_absimilis
    1$_NO_HIGHERTAXON$Nethersia haplotes$	Nethersia sp_ms_haplotes
   21$_NO_HIGHERTAXON$Nethersia maculosa$	Nethersia sp_ms_maculosa
    6$_NO_HIGHERTAXON$Nethersia nigra$	Nethersia sp_ms_nigra
   46$_NO_HIGHERTAXON$Nethersia pilbara$	Nethersia sp_ms_pilbara
   18$_NO_HIGHERTAXON$Nethersia setosa$	Nethersia sp_ms_setosa
   77$_NO_HIGHERTAXON$Nethersia silveirae$	Nethersia sp_ms_silveirae
   11$_NO_HIGHERTAXON$Nethersia sp$	Nethersia sp
    7$_NO_HIGHERTAXON$Nethersia sp_04$	Nethersia sp_04
  114$_NO_HIGHERTAXON$Nethersia sp_ms_acaciaphila$	Nethersia sp_ms_acaciaphila
    2$_NO_HIGHERTAXON$Nethersia sp_ms_appha$	Nethersia sp_ms_appha
    7$_NO_HIGHERTAXON$Nethersia sp_ms_bb_nr_tatarnci$	Nethersia sp_ms_bb_nr_tatarnci
    4$_NO_HIGHERTAXON$Nethersia sp_ms_bipannanota$	Nethersia sp_ms_bipannanota
    4$_NO_HIGHERTAXON$Nethersia sp_ms_boorabbinensis$	Nethersia sp_ms_boorabbinensis
   13$_NO_HIGHERTAXON$Nethersia sp_ms_chazeaui$	Nethersia sp_ms_chazeaui
    4$_NO_HIGHERTAXON$Nethersia sp_ms_costata$	Nethersia sp_ms_costata
   69$_NO_HIGHERTAXON$Nethersia sp_ms_finlayae$	Nethersia sp_ms_finlayae
    4$_NO_HIGHERTAXON$Nethersia sp_ms_kimberlyensis$	Nethersia sp_ms_kimberlyensis
    3$_NO_HIGHERTAXON$Nethersia sp_ms_magna$	Nethersia sp_ms_magna
   19$_NO_HIGHERTAXON$Nethersia sp_ms_mareeba$	Nethersia sp_ms_mareeba
    9$_NO_HIGHERTAXON$Nethersia sp_ms_mcquillani$	Nethersia sp_ms_mcquillani
   19$_NO_HIGHERTAXON$Nethersia sp_ms_stipula$	Nethersia sp_ms_stipula
  199$_NO_HIGHERTAXON$Nethersia sp_ms_tatarnici$	Nethersia sp_ms_tatarnici
   92$_NO_HIGHERTAXON$Nethersia sp_ms_tomentosa$	Nethersia sp_ms_tomentosa
    2$_NO_HIGHERTAXON$Nethersia sp_msp10$	Nethersia sp_msp10
    1$_NO_HIGHERTAXON$Nethersia sp_msp3$	Nethersia sp_msp3
    1$_NO_HIGHERTAXON$Nethersia sp_msp8$	Nethersia sp_msp8
    2$_NO_HIGHERTAXON$Nezara viridula$	Nezara sp_ms_viridula
  207$_NO_HIGHERTAXON$None none$	None sp_ms_none
    1$_NO_HIGHERTAXON$Noualhierana furtiva$	Noualhierana sp_ms_furtiva
   22$_NO_HIGHERTAXON$Novatilla virgata$	Novatilla sp_ms_virgata
    2$_NO_HIGHERTAXON$Nysius vinitor$	Nysius sp_ms_vinitor
   52$_NO_HIGHERTAXON$Oechalia schellenbergii$	Oechalia sp_ms_schellenbergii
    9$_NO_HIGHERTAXON$Oecharis sp$	Oecharis sp
    2$_NO_HIGHERTAXON$Oecophyllodes bipunctatus$	Oecophyllodes sp_ms_bipunctatus
    4$_NO_HIGHERTAXON$Ommatodema leanum$	Ommatodema sp_ms_leanum
    4$_NO_HIGHERTAXON$Ommatodema sp_ms_novaecaledoniae$	Ommatodema sp_ms_novaecaledoniae
   27$_NO_HIGHERTAXON$Ommatodema sp_n_a2$	Ommatodema sp_n_a2
   22$_NO_HIGHERTAXON$Ommatodema sp_n_a3$	Ommatodema sp_n_a3
   20$_NO_HIGHERTAXON$Ommatodema sp_n_b2$	Ommatodema sp_n_b2
  165$_NO_HIGHERTAXON$Ommatodema sp_n_c$	Ommatodema sp_n_c
   62$_NO_HIGHERTAXON$Ommatodema sp_n_d2$	Ommatodema sp_n_d2
    3$_NO_HIGHERTAXON$Ommatodema sp_n_e2$	Ommatodema sp_n_e2
   49$_NO_HIGHERTAXON$Ommatodema sp_n_f2$	Ommatodema sp_n_f2
    2$_NO_HIGHERTAXON$Ommatodema sp_n_g2$	Ommatodema sp_n_g2
   27$_NO_HIGHERTAXON$Omnivoriphylus boiada$	Omnivoriphylus sp_ms_boiada
    1$_NO_HIGHERTAXON$Omnivoriphylus charleville$	Omnivoriphylus sp_ms_charleville
  100$_NO_HIGHERTAXON$Omnivoriphylus frankenii$	Omnivoriphylus sp_ms_frankenii
   86$_NO_HIGHERTAXON$Omnivoriphylus mangaensis$	Omnivoriphylus sp_ms_mangaensis
    1$_NO_HIGHERTAXON$Omnivoriphylus wanarra$	Omnivoriphylus sp_ms_wanarra
    7$_NO_HIGHERTAXON$Omyta centrolineata$	Omyta sp_ms_centrolineata
   80$_NO_HIGHERTAXON$Oncophysa leai$	Oncophysa sp_ms_leai
    2$_NO_HIGHERTAXON$Oncophysa rufescens$	Oncophysa sp_ms_rufescens
  564$_NO_HIGHERTAXON$Oncophysa sp$	Oncophysa sp
    4$_NO_HIGHERTAXON$Oncophysa sp_01$	Oncophysa sp_01
    9$_NO_HIGHERTAXON$Oncophysa sp_02a$	Oncophysa sp_02a
  190$_NO_HIGHERTAXON$Oncophysa sp_02b$	Oncophysa sp_02b
  124$_NO_HIGHERTAXON$Oncophysa sp_04$	Oncophysa sp_04
   85$_NO_HIGHERTAXON$Oncophysa sp_05$	Oncophysa sp_05
   17$_NO_HIGHERTAXON$Oncophysa sp_07$	Oncophysa sp_07
   70$_NO_HIGHERTAXON$Oncophysa sp_08$	Oncophysa sp_08
   60$_NO_HIGHERTAXON$Oncophysa sp_n_lakeshaster$	Oncophysa sp_n_lakeshaster
    4$_NO_HIGHERTAXON$Oncophysa vesiculata ssp. gracilis$	Oncophysa sp_vesiculata_ssp_gracilis
  162$_NO_HIGHERTAXON$Oncophysa vesiculata ssp. nigra$	Oncophysa sp_vesiculata_ssp_nigra
   10$_NO_HIGHERTAXON$Oncophysa vesiculata ssp. vesiculata$	Oncophysa sp_vesiculata_ssp_vesiculata
  104$_NO_HIGHERTAXON$Oncophysa vesiculata$	Oncophysa sp_ms_vesiculata
    1$_NO_HIGHERTAXON$Ontiscus sp.$	Ontiscus sp.
    2$_NO_HIGHERTAXON$Onymocoris izzardi$	Onymocoris sp_ms_izzardi
    2$_NO_HIGHERTAXON$Ooldeon maculipes$	Ooldeon sp_ms_maculipes
   26$_NO_HIGHERTAXON$Ooldeon sp_1$	Ooldeon sp_1
    3$_NO_HIGHERTAXON$Ooldeon sp_2$	Ooldeon sp_2
   14$_NO_HIGHERTAXON$Orotingis eueides$	Orotingis sp_ms_eueides
    2$_NO_HIGHERTAXON$Orthotylus sidnicus$	Orthotylus sp_ms_sidnicus
    2$_NO_HIGHERTAXON$Orthotylus sp.$	Orthotylus sp.
   15$_NO_HIGHERTAXON$Orthotylus sp_ms_actinostrobus$	Orthotylus sp_ms_actinostrobus
   30$_NO_HIGHERTAXON$Orthotylus sp_ms_antennarubrus$	Orthotylus sp_ms_antennarubrus
    7$_NO_HIGHERTAXON$Orthotylus sp_ms_aptus$	Orthotylus sp_ms_aptus
   30$_NO_HIGHERTAXON$Orthotylus sp_ms_aus1_and_2$	Orthotylus sp_ms_aus1_and_2
   39$_NO_HIGHERTAXON$Orthotylus sp_ms_avoni$	Orthotylus sp_ms_avoni
    4$_NO_HIGHERTAXON$Orthotylus sp_ms_ballina$	Orthotylus sp_ms_ballina
   36$_NO_HIGHERTAXON$Orthotylus sp_ms_bundjalungi$	Orthotylus sp_ms_bundjalungi
    3$_NO_HIGHERTAXON$Orthotylus sp_ms_coolgardie$	Orthotylus sp_ms_coolgardie
   13$_NO_HIGHERTAXON$Orthotylus sp_ms_cordylinus$	Orthotylus sp_ms_cordylinus
   92$_NO_HIGHERTAXON$Orthotylus sp_ms_drepanomorphus$	Orthotylus sp_ms_drepanomorphus
   14$_NO_HIGHERTAXON$Orthotylus sp_ms_emeraldi$	Orthotylus sp_ms_emeraldi
    4$_NO_HIGHERTAXON$Orthotylus sp_ms_endlicheriphilus$	Orthotylus sp_ms_endlicheriphilus
    9$_NO_HIGHERTAXON$Orthotylus sp_ms_erythroptera$	Orthotylus sp_ms_erythroptera
   25$_NO_HIGHERTAXON$Orthotylus sp_ms_finlayi$	Orthotylus sp_ms_finlayi
    8$_NO_HIGHERTAXON$Orthotylus sp_ms_gammoni$	Orthotylus sp_ms_gammoni
   44$_NO_HIGHERTAXON$Orthotylus sp_ms_glaucophylla$	Orthotylus sp_ms_glaucophylla
   32$_NO_HIGHERTAXON$Orthotylus sp_ms_graciliphilus$	Orthotylus sp_ms_graciliphilus
    4$_NO_HIGHERTAXON$Orthotylus sp_ms_hochuli$	Orthotylus sp_ms_hochuli
  146$_NO_HIGHERTAXON$Orthotylus sp_ms_intratropica$	Orthotylus sp_ms_intratropica
   72$_NO_HIGHERTAXON$Orthotylus sp_ms_kalbarri$	Orthotylus sp_ms_kalbarri
   27$_NO_HIGHERTAXON$Orthotylus sp_ms_lepidothrix$	Orthotylus sp_ms_lepidothrix
    8$_NO_HIGHERTAXON$Orthotylus sp_ms_lochada$	Orthotylus sp_ms_lochada
   32$_NO_HIGHERTAXON$Orthotylus sp_ms_majori$	Orthotylus sp_ms_majori
    5$_NO_HIGHERTAXON$Orthotylus sp_ms_molloyi$	Orthotylus sp_ms_molloyi
    7$_NO_HIGHERTAXON$Orthotylus sp_ms_naranjoclypeatus$	Orthotylus sp_ms_naranjoclypeatus
   94$_NO_HIGHERTAXON$Orthotylus sp_ms_notodytikos$	Orthotylus sp_ms_notodytikos
   42$_NO_HIGHERTAXON$Orthotylus sp_ms_paluma$	Orthotylus sp_ms_paluma
   12$_NO_HIGHERTAXON$Orthotylus sp_ms_parawirra$	Orthotylus sp_ms_parawirra
   19$_NO_HIGHERTAXON$Orthotylus sp_ms_preissii$	Orthotylus sp_ms_preissii
   37$_NO_HIGHERTAXON$Orthotylus sp_ms_pullabooka$	Orthotylus sp_ms_pullabooka
   85$_NO_HIGHERTAXON$Orthotylus sp_ms_schuhi$	Orthotylus sp_ms_schuhi
    1$_NO_HIGHERTAXON$Orthotylus sp_ms_scorpioni$	Orthotylus sp_ms_scorpioni
    9$_NO_HIGHERTAXON$Orthotylus sp_ms_silveirae$	Orthotylus sp_ms_silveirae
  218$_NO_HIGHERTAXON$Orthotylus sp_ms_sydneyensis$	Orthotylus sp_ms_sydneyensis
    5$_NO_HIGHERTAXON$Orthotylus sp_ms_tatarnici$	Orthotylus sp_ms_tatarnici
    3$_NO_HIGHERTAXON$Orthotylus sp_ms_wollemi$	Orthotylus sp_ms_wollemi
   27$_NO_HIGHERTAXON$Orthotylus sp_ms_xerophilus$	Orthotylus sp_ms_xerophilus
    1$_NO_HIGHERTAXON$Oxycarenus arctatus$	Oxycarenus sp_ms_arctatus
    1$_NO_HIGHERTAXON$Pachygrontha semperi$	Pachygrontha sp_ms_semperi
    2$_NO_HIGHERTAXON$Pachypeltis annulipes$	Pachypeltis sp_ms_annulipes
   13$_NO_HIGHERTAXON$Pachypeltis chinensis$	Pachypeltis sp_ms_chinensis
   14$_NO_HIGHERTAXON$Pachypeltis haglundii$	Pachypeltis sp_ms_haglundii
    1$_NO_HIGHERTAXON$Pachypeltis politum$	Pachypeltis sp_ms_politum
   33$_NO_HIGHERTAXON$Pachypeltis reuteri$	Pachypeltis sp_ms_reuteri
   15$_NO_HIGHERTAXON$Pachypeltis sp.$	Pachypeltis sp.
    1$_NO_HIGHERTAXON$Pachypeltopsis australicus$	Pachypeltopsis sp_ms_australicus
    2$_NO_HIGHERTAXON$Palaucoris novaguineae$	Palaucoris sp_ms_novaguineae
    3$_NO_HIGHERTAXON$Palaucoris sp$	Palaucoris sp
   12$_NO_HIGHERTAXON$Palaucoris sp_nov_1$	Palaucoris sp_nov_1
    6$_NO_HIGHERTAXON$Palaucoris sulawesicus$	Palaucoris sp_ms_sulawesicus
    1$_NO_HIGHERTAXON$Pamerapa thoracica$	Pamerapa sp_ms_thoracica
    3$_NO_HIGHERTAXON$Papuamimus irianicus$	Papuamimus sp_ms_irianicus
   46$_NO_HIGHERTAXON$Papuamimus maai$	Papuamimus sp_ms_maai
    3$_NO_HIGHERTAXON$Papuamimus sp_nr_iranicus$	Papuamimus sp_nr_iranicus
   15$_NO_HIGHERTAXON$Papuamiroides elongatus$	Papuamiroides sp_ms_elongatus
    4$_NO_HIGHERTAXON$Paracimex borneensis$	Paracimex sp_ms_borneensis
   19$_NO_HIGHERTAXON$Paracimex caledoniae$	Paracimex sp_ms_caledoniae
   35$_NO_HIGHERTAXON$Paracimex capitatus$	Paracimex sp_ms_capitatus
    2$_NO_HIGHERTAXON$Paracimex setosus$	Paracimex sp_ms_setosus
    1$_NO_HIGHERTAXON$Paracimex sp.$	Paracimex sp.
   20$_NO_HIGHERTAXON$Paracopium albofasciatum$	Paracopium sp_ms_albofasciatum
   61$_NO_HIGHERTAXON$Paracopium australicum$	Paracopium sp_ms_australicum
   42$_NO_HIGHERTAXON$Paracopium furvum$	Paracopium sp_ms_furvum
   10$_NO_HIGHERTAXON$Paracopium sp_02$	Paracopium sp_02
    4$_NO_HIGHERTAXON$Paracopium sp_03$	Paracopium sp_03
    3$_NO_HIGHERTAXON$Paracopium sp_05$	Paracopium sp_05
   17$_NO_HIGHERTAXON$Paracopium summervillei$	Paracopium sp_ms_summervillei
   13$_NO_HIGHERTAXON$Paracylapus sp.$	Paracylapus sp.
   27$_NO_HIGHERTAXON$Parada approba$	Parada sp_ms_approba
    2$_NO_HIGHERTAXON$Parada popla ssp. nigrantis$	Parada sp_popla_ssp_nigrantis
   26$_NO_HIGHERTAXON$Parada popla ssp. popla$	Parada sp_popla_ssp_popla
   28$_NO_HIGHERTAXON$Parada sp$	Parada sp
    2$_NO_HIGHERTAXON$Parada sp_01_nr_taeniophora$	Parada sp_01_nr_taeniophora
    3$_NO_HIGHERTAXON$Parada sp_04$	Parada sp_04
    1$_NO_HIGHERTAXON$Parada sp_05$	Parada sp_05
    2$_NO_HIGHERTAXON$Parada sp_07$	Parada sp_07
    1$_NO_HIGHERTAXON$Parada sp_08$	Parada sp_08
   15$_NO_HIGHERTAXON$Parada taeniophora$	Parada sp_ms_taeniophora
    7$_NO_HIGHERTAXON$Parada torta ssp. torta$	Parada sp_torta_ssp_torta
    4$_NO_HIGHERTAXON$Paragenor sp_1$	Paragenor sp_1
    1$_NO_HIGHERTAXON$Paragerbelius typicus$	Paragerbelius sp_ms_typicus
    1$_NO_HIGHERTAXON$Paratopus sp.$	Paratopus sp.
    4$_NO_HIGHERTAXON$Paratopus sp_ms_brunocapitus$	Paratopus sp_ms_brunocapitus
    1$_NO_HIGHERTAXON$Paurolygus scutatus$	Paurolygus sp_ms_scutatus
    1$_NO_HIGHERTAXON$Peirates punctorius$	Peirates sp_ms_punctorius
    3$_NO_HIGHERTAXON$Perissonemia sodalis$	Perissonemia sp_ms_sodalis
   15$_NO_HIGHERTAXON$Peritropis bassetti$	Peritropis sp_ms_bassetti
  144$_NO_HIGHERTAXON$Peritropis punctatus$	Peritropis sp_ms_punctatus
   47$_NO_HIGHERTAXON$Peritropis sp.$	Peritropis sp.
    1$_NO_HIGHERTAXON$Phaenacantha australiae$	Phaenacantha sp_ms_australiae
    1$_NO_HIGHERTAXON$Phaenacantha sp$	Phaenacantha sp
    4$_NO_HIGHERTAXON$Phatnoma hackeri$	Phatnoma sp_ms_hackeri
    4$_NO_HIGHERTAXON$Phatnoma sp_ms_pacifica$	Phatnoma sp_ms_pacifica
    3$_NO_HIGHERTAXON$Physatocheila biseriata$	Physatocheila sp_ms_biseriata
    3$_NO_HIGHERTAXON$Physatocheila civatis$	Physatocheila sp_ms_civatis
   16$_NO_HIGHERTAXON$Physatocheila objicis$	Physatocheila sp_ms_objicis
    3$_NO_HIGHERTAXON$Physatocheila sp$	Physatocheila sp
    1$_NO_HIGHERTAXON$Physatocheila sp_ms_watagans$	Physatocheila sp_ms_watagans
    6$_NO_HIGHERTAXON$Physatocheila suttoni$	Physatocheila sp_ms_suttoni
   19$_NO_HIGHERTAXON$Physatocheila uniseriata$	Physatocheila sp_ms_uniseriata
   31$_NO_HIGHERTAXON$Piezodorus oceanicus$	Piezodorus sp_ms_oceanicus
    3$_NO_HIGHERTAXON$Pilophorus alstoni$	Pilophorus sp_ms_alstoni
    1$_NO_HIGHERTAXON$Pilophorus arboreus$	Pilophorus sp_ms_arboreus
    2$_NO_HIGHERTAXON$Pilophorus daradae$	Pilophorus sp_ms_daradae
    2$_NO_HIGHERTAXON$Pilophorus kockensis$	Pilophorus sp_ms_kockensis
    2$_NO_HIGHERTAXON$Pilophorus myrmecoides$	Pilophorus sp_ms_myrmecoides
    2$_NO_HIGHERTAXON$Pilophorus palawana$	Pilophorus sp_ms_palawana
    1$_NO_HIGHERTAXON$Pilophorus prolixus$	Pilophorus sp_ms_prolixus
   25$_NO_HIGHERTAXON$Pirricoris annectans$	Pirricoris sp_ms_annectans
   21$_NO_HIGHERTAXON$Pirricoris sp_1$	Pirricoris sp_1
    1$_NO_HIGHERTAXON$Pirricoris sp_2$	Pirricoris sp_2
   12$_NO_HIGHERTAXON$Platycoris minimus$	Platycoris sp_ms_minimus
    4$_NO_HIGHERTAXON$Platyngomiris coreoides$	Platyngomiris sp_ms_coreoides
   30$_NO_HIGHERTAXON$Plautia sp_1$	Plautia sp_1
    1$_NO_HIGHERTAXON$Plinthisus sp$	Plinthisus sp
    1$_NO_HIGHERTAXON$Poecilobdallus gratiosus$	Poecilobdallus sp_ms_gratiosus
    3$_NO_HIGHERTAXON$Poecilometis armatus$	Poecilometis sp_ms_armatus
   17$_NO_HIGHERTAXON$Poecilometis fuscescens$	Poecilometis sp_ms_fuscescens
    2$_NO_HIGHERTAXON$Poecilometis punctiventris$	Poecilometis sp_ms_punctiventris
    1$_NO_HIGHERTAXON$Poecilometis sp_1$	Poecilometis sp_1
   12$_NO_HIGHERTAXON$Poecilotoma sp_1$	Poecilotoma sp_1
    2$_NO_HIGHERTAXON$Poecilotoma sp_2$	Poecilotoma sp_2
  167$_NO_HIGHERTAXON$Polyozus australianus$	Polyozus sp_ms_australianus
    2$_NO_HIGHERTAXON$Polyozus bifurcata$	Polyozus sp_ms_bifurcata
   62$_NO_HIGHERTAXON$Polyozus bulita$	Polyozus sp_ms_bulita
  131$_NO_HIGHERTAXON$Polyozus furcilla$	Polyozus sp_ms_furcilla
  189$_NO_HIGHERTAXON$Polyozus galbanus$	Polyozus sp_ms_galbanus
   57$_NO_HIGHERTAXON$Polyozus kojonup$	Polyozus sp_ms_kojonup
   65$_NO_HIGHERTAXON$Polyozus kuringgai$	Polyozus sp_ms_kuringgai
   50$_NO_HIGHERTAXON$Polyozus manilla$	Polyozus sp_ms_manilla
   13$_NO_HIGHERTAXON$Polyozus mina$	Polyozus sp_ms_mina
    8$_NO_HIGHERTAXON$Polyozus tridens$	Polyozus sp_ms_tridens
   15$_NO_HIGHERTAXON$Porander scudderi$	Porander sp_ms_scudderi
    6$_NO_HIGHERTAXON$Porophoroptera excellens$	Porophoroptera sp_ms_excellens
    5$_NO_HIGHERTAXON$Porphyrocapsus sp_ms_lineatus$	Porphyrocapsus sp_ms_lineatus
    4$_NO_HIGHERTAXON$Porphyrodema rhinoceros$	Porphyrodema sp_ms_rhinoceros
  416$_NO_HIGHERTAXON$Protemiris adenanthi$	Protemiris sp_ms_adenanthi
  250$_NO_HIGHERTAXON$Protemiris conospermi$	Protemiris sp_ms_conospermi
   94$_NO_HIGHERTAXON$Protemiris distichi$	Protemiris sp_ms_distichi
  188$_NO_HIGHERTAXON$Protemiris grevilleae$	Protemiris sp_ms_grevilleae
  158$_NO_HIGHERTAXON$Protemiris isopogoni$	Protemiris sp_ms_isopogoni
  117$_NO_HIGHERTAXON$Protemiris sp_101$	Protemiris sp_101
    2$_NO_HIGHERTAXON$Protemiris sp_127$	Protemiris sp_127
    6$_NO_HIGHERTAXON$Protemiris sp_220$	Protemiris sp_220
   47$_NO_HIGHERTAXON$Proteophylus acacii$	Proteophylus sp_ms_acacii
  245$_NO_HIGHERTAXON$Proteophylus grevilleae$	Proteophylus sp_ms_grevilleae
   15$_NO_HIGHERTAXON$Proteophylus occidentalis$	Proteophylus sp_ms_occidentalis
   25$_NO_HIGHERTAXON$Proteophylus orientalis$	Proteophylus sp_ms_orientalis
  151$_NO_HIGHERTAXON$Proteophylus petrophile$	Proteophylus sp_ms_petrophile
    3$_NO_HIGHERTAXON$Psallops sp.$	Psallops sp.
    8$_NO_HIGHERTAXON$Pseudapines geminata$	Pseudapines sp_ms_geminata
   13$_NO_HIGHERTAXON$Pseudodoniella pacifica$	Pseudodoniella sp_ms_pacifica
    7$_NO_HIGHERTAXON$Pseudodoniella typica$	Pseudodoniella sp_ms_typica
    2$_NO_HIGHERTAXON$Pseudoloxops sp_1$	Pseudoloxops sp_1
    7$_NO_HIGHERTAXON$Pseudoloxops sp_116rh$	Pseudoloxops sp_116rh
    4$_NO_HIGHERTAXON$Pseudoloxops sp_117rh$	Pseudoloxops sp_117rh
    3$_NO_HIGHERTAXON$Pseudoloxops sp_118rh$	Pseudoloxops sp_118rh
    3$_NO_HIGHERTAXON$Pseudoloxops sp_119rh$	Pseudoloxops sp_119rh
    2$_NO_HIGHERTAXON$Pseudoloxops sp_120rh$	Pseudoloxops sp_120rh
    3$_NO_HIGHERTAXON$Pseudoloxops sp_121rh$	Pseudoloxops sp_121rh
    1$_NO_HIGHERTAXON$Pseudoloxops sp_122rh$	Pseudoloxops sp_122rh
    1$_NO_HIGHERTAXON$Pseudoloxops sp_123rh$	Pseudoloxops sp_123rh
    1$_NO_HIGHERTAXON$Pseudoloxops sp_124rh$	Pseudoloxops sp_124rh
    1$_NO_HIGHERTAXON$Pseudoloxops sp_125rh$	Pseudoloxops sp_125rh
    1$_NO_HIGHERTAXON$Pseudoloxops sp_126rh$	Pseudoloxops sp_126rh
    1$_NO_HIGHERTAXON$Pseudoloxops sp_127rh$	Pseudoloxops sp_127rh
    1$_NO_HIGHERTAXON$Pseudoloxops sp_128rh$	Pseudoloxops sp_128rh
    1$_NO_HIGHERTAXON$Pseudoloxops sp_129rh$	Pseudoloxops sp_129rh
    1$_NO_HIGHERTAXON$Pseudoloxops sp_130rh$	Pseudoloxops sp_130rh
    1$_NO_HIGHERTAXON$Pseudoloxops sp_131rh$	Pseudoloxops sp_131rh
    1$_NO_HIGHERTAXON$Pseudoloxops sp_132rh$	Pseudoloxops sp_132rh
    2$_NO_HIGHERTAXON$Pseudoloxops sp_133rh$	Pseudoloxops sp_133rh
    1$_NO_HIGHERTAXON$Pseudoloxops sp_134rh$	Pseudoloxops sp_134rh
    1$_NO_HIGHERTAXON$Pseudoloxops sp_137rh$	Pseudoloxops sp_137rh
    1$_NO_HIGHERTAXON$Pseudoloxops sp_139rh$	Pseudoloxops sp_139rh
    1$_NO_HIGHERTAXON$Pseudoloxops sp_142rh$	Pseudoloxops sp_142rh
    1$_NO_HIGHERTAXON$Pseudoloxops sp_143rh$	Pseudoloxops sp_143rh
    2$_NO_HIGHERTAXON$Pseudoloxops sp_144rh$	Pseudoloxops sp_144rh
    1$_NO_HIGHERTAXON$Pseudoloxops sp_146rh$	Pseudoloxops sp_146rh
    2$_NO_HIGHERTAXON$Pseudoloxops sp_147a_rh$	Pseudoloxops sp_147a_rh
    1$_NO_HIGHERTAXON$Pseudoloxops sp_148rh$	Pseudoloxops sp_148rh
    2$_NO_HIGHERTAXON$Pseudoloxops sp_149rh$	Pseudoloxops sp_149rh
  118$_NO_HIGHERTAXON$Pseudoloxops sp_155rh$	Pseudoloxops sp_155rh
    1$_NO_HIGHERTAXON$Pseudoloxops sp_17rh$	Pseudoloxops sp_17rh
    2$_NO_HIGHERTAXON$Pseudoloxops sp_18rh$	Pseudoloxops sp_18rh
    1$_NO_HIGHERTAXON$Pseudoloxops sp_19rh$	Pseudoloxops sp_19rh
    2$_NO_HIGHERTAXON$Pseudoloxops sp_2$	Pseudoloxops sp_2
    2$_NO_HIGHERTAXON$Pseudoloxops sp_20rh$	Pseudoloxops sp_20rh
    1$_NO_HIGHERTAXON$Pseudoloxops sp_22rh$	Pseudoloxops sp_22rh
    2$_NO_HIGHERTAXON$Pseudoloxops sp_23rh$	Pseudoloxops sp_23rh
    2$_NO_HIGHERTAXON$Pseudoloxops sp_24rh$	Pseudoloxops sp_24rh
    1$_NO_HIGHERTAXON$Pseudoloxops sp_30rh$	Pseudoloxops sp_30rh
    1$_NO_HIGHERTAXON$Pseudoloxops sp_35rh$	Pseudoloxops sp_35rh
    3$_NO_HIGHERTAXON$Pseudoloxops sp_36rh$	Pseudoloxops sp_36rh
    2$_NO_HIGHERTAXON$Pseudoloxops sp_37rh$	Pseudoloxops sp_37rh
    6$_NO_HIGHERTAXON$Pseudoloxops sp_41rh$	Pseudoloxops sp_41rh
    2$_NO_HIGHERTAXON$Pseudoloxops sp_68a_rh$	Pseudoloxops sp_68a_rh
    2$_NO_HIGHERTAXON$Pseudoloxops sp_68b_rh$	Pseudoloxops sp_68b_rh
   11$_NO_HIGHERTAXON$Pseudoloxops sp_68rh$	Pseudoloxops sp_68rh
    1$_NO_HIGHERTAXON$Pseudoloxops sp_69a_rh$	Pseudoloxops sp_69a_rh
    1$_NO_HIGHERTAXON$Pseudoloxops sp_69rh$	Pseudoloxops sp_69rh
    3$_NO_HIGHERTAXON$Pseudoloxops sp_70rh$	Pseudoloxops sp_70rh
    1$_NO_HIGHERTAXON$Pseudoloxops sp_72_rh$	Pseudoloxops sp_72_rh
    1$_NO_HIGHERTAXON$Pseudoloxops sp_74rh$	Pseudoloxops sp_74rh
    1$_NO_HIGHERTAXON$Pseudoloxops sp_75rh$	Pseudoloxops sp_75rh
   27$_NO_HIGHERTAXON$Pseudoloxops sp_ms_baiawaensis$	Pseudoloxops sp_ms_baiawaensis
    1$_NO_HIGHERTAXON$Pseudoloxops sp_ms_cheesmanae$	Pseudoloxops sp_ms_cheesmanae
    1$_NO_HIGHERTAXON$Pseudoloxops sp_ms_cordiformis$	Pseudoloxops sp_ms_cordiformis
    3$_NO_HIGHERTAXON$Pseudoloxops sp_ms_efatensis$	Pseudoloxops sp_ms_efatensis
    1$_NO_HIGHERTAXON$Pseudoloxops sp_ms_gagnei$	Pseudoloxops sp_ms_gagnei
    1$_NO_HIGHERTAXON$Pseudoloxops sp_ms_kimiensis$	Pseudoloxops sp_ms_kimiensis
   11$_NO_HIGHERTAXON$Pseudoloxops sp_ms_kraussi$	Pseudoloxops sp_ms_kraussi
    1$_NO_HIGHERTAXON$Pseudoloxops sp_ms_lenakelensis$	Pseudoloxops sp_ms_lenakelensis
    5$_NO_HIGHERTAXON$Pseudoloxops sp_ms_mcilwraithensis$	Pseudoloxops sp_ms_mcilwraithensis
    3$_NO_HIGHERTAXON$Pseudoloxops sp_ms_mourangeensis$	Pseudoloxops sp_ms_mourangeensis
    1$_NO_HIGHERTAXON$Pseudoloxops sp_ms_naraiyawa$	Pseudoloxops sp_ms_naraiyawa
   27$_NO_HIGHERTAXON$Pseudoloxops sp_ms_pancheriaphila$	Pseudoloxops sp_ms_pancheriaphila
    5$_NO_HIGHERTAXON$Pseudoloxops sp_ms_sakaiana$	Pseudoloxops sp_ms_sakaiana
    9$_NO_HIGHERTAXON$Pseudoloxops sp_ms_solomensis$	Pseudoloxops sp_ms_solomensis
    3$_NO_HIGHERTAXON$Pseudoloxops sp_ms_straatmani$	Pseudoloxops sp_ms_straatmani
   20$_NO_HIGHERTAXON$Pseudoloxops sp_ms_tabwemasana$	Pseudoloxops sp_ms_tabwemasana
    5$_NO_HIGHERTAXON$Pseudoloxops sp_ms_tatarnici$	Pseudoloxops sp_ms_tatarnici
    1$_NO_HIGHERTAXON$Pseudoloxops sp_ms_wareo$	Pseudoloxops sp_ms_wareo
   29$_NO_HIGHERTAXON$Pseudoloxops sp_ms_woodwardi$	Pseudoloxops sp_ms_woodwardi
   15$_NO_HIGHERTAXON$Pseudoloxops vitiensis$	Pseudoloxops sp_ms_vitiensis
    1$_NO_HIGHERTAXON$Psophis sp$	Psophis sp
   30$_NO_HIGHERTAXON$Ptilocnemus borealis$	Ptilocnemus sp_ms_borealis
   23$_NO_HIGHERTAXON$Ptilocnemus distinctus$	Ptilocnemus sp_ms_distinctus
    4$_NO_HIGHERTAXON$Ptilocnemus femoralis$	Ptilocnemus sp_ms_femoralis
    1$_NO_HIGHERTAXON$Ptilocnemus kakaduensis$	Ptilocnemus sp_ms_kakaduensis
  116$_NO_HIGHERTAXON$Ptilocnemus lemur$	Ptilocnemus sp_ms_lemur
   43$_NO_HIGHERTAXON$Ptilocnemus pallidus$	Ptilocnemus sp_ms_pallidus
   67$_NO_HIGHERTAXON$Ptilocnemus sidnicus$	Ptilocnemus sp_ms_sidnicus
   22$_NO_HIGHERTAXON$Ptilocnemus sp_ms_albesco$	Ptilocnemus sp_ms_albesco
    6$_NO_HIGHERTAXON$Ptilocnemus sp_ms_exsanguis$	Ptilocnemus sp_ms_exsanguis
   93$_NO_HIGHERTAXON$Ptilocnemus vittatus$	Ptilocnemus sp_ms_vittatus
    1$_NO_HIGHERTAXON$Pulvillophylus angustus$	Pulvillophylus sp_ms_angustus
    2$_NO_HIGHERTAXON$Pulvillophylus croninensis$	Pulvillophylus sp_ms_croninensis
    1$_NO_HIGHERTAXON$Pulvillophylus cuneomaculatus n. sp. 1$	Pulvillophylus sp_cuneomaculatus_n_sp_1
   25$_NO_HIGHERTAXON$Pulvillophylus cuneotinctus$	Pulvillophylus sp_ms_cuneotinctus
   11$_NO_HIGHERTAXON$Pulvillophylus ecdeiocoleus n. sp. 2$	Pulvillophylus sp_ecdeiocoleus_n_sp_2
   77$_NO_HIGHERTAXON$Pulvillophylus rossi$	Pulvillophylus sp_ms_rossi
    1$_NO_HIGHERTAXON$Pulvillophylus rubritinctus$	Pulvillophylus sp_ms_rubritinctus
    1$_NO_HIGHERTAXON$Pulvillophylus sp.$	Pulvillophylus sp.
    4$_NO_HIGHERTAXON$Radinacantha darwini$	Radinacantha sp_ms_darwini
    1$_NO_HIGHERTAXON$Radinacantha dondiorum$	Radinacantha sp_ms_dondiorum
    5$_NO_HIGHERTAXON$Radinacantha reticulata$	Radinacantha sp_ms_reticulata
   13$_NO_HIGHERTAXON$Radinacantha sp$	Radinacantha sp
    5$_NO_HIGHERTAXON$Radinacantha sp_01$	Radinacantha sp_01
    1$_NO_HIGHERTAXON$Radinacantha tasmanica$	Radinacantha sp_ms_tasmanica
    1$_NO_HIGHERTAXON$Ragwelellus gressitti$	Ragwelellus sp_ms_gressitti
    4$_NO_HIGHERTAXON$Ragwelellus horvathi$	Ragwelellus sp_ms_horvathi
    9$_NO_HIGHERTAXON$Ragwelellus indonesicus$	Ragwelellus sp_ms_indonesicus
    1$_NO_HIGHERTAXON$Ragwelellus luteonotatus$	Ragwelellus sp_ms_luteonotatus
    3$_NO_HIGHERTAXON$Ragwelellus magnificus$	Ragwelellus sp_ms_magnificus
    2$_NO_HIGHERTAXON$Ragwelellus morobensis$	Ragwelellus sp_ms_morobensis
    2$_NO_HIGHERTAXON$Ragwelellus nigrus$	Ragwelellus sp_ms_nigrus
   25$_NO_HIGHERTAXON$Ragwelellus pallipes$	Ragwelellus sp_ms_pallipes
    1$_NO_HIGHERTAXON$Ragwelellus similis$	Ragwelellus sp_ms_similis
   23$_NO_HIGHERTAXON$Ragwelellus sp$	Ragwelellus sp
   74$_NO_HIGHERTAXON$Ragwelellus suspectus$	Ragwelellus sp_ms_suspectus
   51$_NO_HIGHERTAXON$Ragwelellus thetis$	Ragwelellus sp_ms_thetis
   31$_NO_HIGHERTAXON$Ragwelellus vittatus$	Ragwelellus sp_ms_vittatus
  386$_NO_HIGHERTAXON$Rayieria acaciae$	Rayieria sp_ms_acaciae
   19$_NO_HIGHERTAXON$Rayieria albaornata$	Rayieria sp_ms_albaornata
  290$_NO_HIGHERTAXON$Rayieria basifer$	Rayieria sp_ms_basifer
   71$_NO_HIGHERTAXON$Rayieria decorata$	Rayieria sp_ms_decorata
   11$_NO_HIGHERTAXON$Rayieria frontalis$	Rayieria sp_ms_frontalis
   68$_NO_HIGHERTAXON$Rayieria gearyi$	Rayieria sp_ms_gearyi
    9$_NO_HIGHERTAXON$Rayieria grandiocula$	Rayieria sp_ms_grandiocula
  128$_NO_HIGHERTAXON$Rayieria kennedyi$	Rayieria sp_ms_kennedyi
    3$_NO_HIGHERTAXON$Rayieria minuta$	Rayieria sp_ms_minuta
    7$_NO_HIGHERTAXON$Rayieria queenslandica$	Rayieria sp_ms_queenslandica
    3$_NO_HIGHERTAXON$Rayieria rubranigra$	Rayieria sp_ms_rubranigra
   22$_NO_HIGHERTAXON$Rayieria sp$	Rayieria sp
    1$_NO_HIGHERTAXON$Remaudiereana inornata$	Remaudiereana sp_ms_inornata
  188$_NO_HIGHERTAXON$Restiophylus hypolaenae$	Restiophylus sp_ms_hypolaenae
  307$_NO_HIGHERTAXON$Restiophylus leptocarpi$	Restiophylus sp_ms_leptocarpi
  238$_NO_HIGHERTAXON$Restiophylus lyginiae$	Restiophylus sp_ms_lyginiae
   18$_NO_HIGHERTAXON$Restiophylus meeboldinae$	Restiophylus sp_ms_meeboldinae
    1$_NO_HIGHERTAXON$Rhinocylapus sp.$	Rhinocylapus sp.
    1$_NO_HIGHERTAXON$Riptortus linearis$	Riptortus sp_ms_linearis
    2$_NO_HIGHERTAXON$Sagittacopula sp_ms_carvalhoi$	Sagittacopula sp_ms_carvalhoi
    2$_NO_HIGHERTAXON$Sagittacopula sp_ms_rufescens$	Sagittacopula sp_ms_rufescens
    1$_NO_HIGHERTAXON$Saldula ornatula$	Saldula sp_ms_ornatula
    1$_NO_HIGHERTAXON$Sastrapada sp.$	Sastrapada sp.
  292$_NO_HIGHERTAXON$Scholtzicoris linnavuorii$	Scholtzicoris sp_ms_linnavuorii
    8$_NO_HIGHERTAXON$Schuhirandella fulva$	Schuhirandella sp_ms_fulva
   19$_NO_HIGHERTAXON$Sciocoris obscurus$	Sciocoris sp_ms_obscurus
   11$_NO_HIGHERTAXON$Sciomenida mcfarlandi$	Sciomenida sp_ms_mcfarlandi
    8$_NO_HIGHERTAXON$Sejanus biniguni$	Sejanus sp_ms_biniguni
    5$_NO_HIGHERTAXON$Sejanus brassi$	Sejanus sp_ms_brassi
  110$_NO_HIGHERTAXON$Sejanus brittoni$	Sejanus sp_ms_brittoni
    9$_NO_HIGHERTAXON$Sejanus cinnameus$	Sejanus sp_ms_cinnameus
    1$_NO_HIGHERTAXON$Sejanus ecnomioides$	Sejanus sp_ms_ecnomioides
   12$_NO_HIGHERTAXON$Sejanus ecnomios$	Sejanus sp_ms_ecnomios
    7$_NO_HIGHERTAXON$Sejanus ecnomiscos$	Sejanus sp_ms_ecnomiscos
    9$_NO_HIGHERTAXON$Sejanus elongatus$	Sejanus sp_ms_elongatus
   17$_NO_HIGHERTAXON$Sejanus fasciatus$	Sejanus sp_ms_fasciatus
    7$_NO_HIGHERTAXON$Sejanus fijiensis$	Sejanus sp_ms_fijiensis
   19$_NO_HIGHERTAXON$Sejanus funerellus$	Sejanus sp_ms_funerellus
    5$_NO_HIGHERTAXON$Sejanus funerioides$	Sejanus sp_ms_funerioides
   28$_NO_HIGHERTAXON$Sejanus howardae$	Sejanus sp_ms_howardae
    1$_NO_HIGHERTAXON$Sejanus isarog$	Sejanus sp_ms_isarog
    6$_NO_HIGHERTAXON$Sejanus leai$	Sejanus sp_ms_leai
    2$_NO_HIGHERTAXON$Sejanus neofunereus$	Sejanus sp_ms_neofunereus
    2$_NO_HIGHERTAXON$Sejanus novocaledonicus$	Sejanus sp_ms_novocaledonicus
    4$_NO_HIGHERTAXON$Sejanus nsp moses ck.$	Sejanus sp_nsp_moses_ck
    1$_NO_HIGHERTAXON$Sejanus nsp$	Sejanus sp_ms_nsp
    3$_NO_HIGHERTAXON$Sejanus occidentalis$	Sejanus sp_ms_occidentalis
   18$_NO_HIGHERTAXON$Sejanus palumae$	Sejanus sp_ms_palumae
    8$_NO_HIGHERTAXON$Sejanus serrulatus$	Sejanus sp_ms_serrulatus
   18$_NO_HIGHERTAXON$Sejanus sinuosus$	Sejanus sp_ms_sinuosus
    1$_NO_HIGHERTAXON$Sejanus sp.$	Sejanus sp.
    1$_NO_HIGHERTAXON$Sejanus spiculatus$	Sejanus sp_ms_spiculatus
   10$_NO_HIGHERTAXON$Sejanus umi$	Sejanus sp_ms_umi
   11$_NO_HIGHERTAXON$Sejanus unicolor$	Sejanus sp_ms_unicolor
    1$_NO_HIGHERTAXON$Setocoris russelli$	Setocoris sp_ms_russelli
    6$_NO_HIGHERTAXON$Sidnia kinbergi$	Sidnia sp_ms_kinbergi
    3$_NO_HIGHERTAXON$Singhalesia sp$	Singhalesia sp
    4$_NO_HIGHERTAXON$Sinistropa elongatus$	Sinistropa sp_ms_elongatus
    2$_NO_HIGHERTAXON$Sinistropa kulgera$	Sinistropa sp_ms_kulgera
    6$_NO_HIGHERTAXON$Sinistropa northami$	Sinistropa sp_ms_northami
    1$_NO_HIGHERTAXON$Sinistropa rawlinna$	Sinistropa sp_ms_rawlinna
    1$_NO_HIGHERTAXON$Sirthenea sp_3$	Sirthenea sp_3
    1$_NO_HIGHERTAXON$Solomonomimus roroni$	Solomonomimus sp_ms_roroni
   77$_NO_HIGHERTAXON$Spinivesica crenulata$	Spinivesica sp_ms_crenulata
   11$_NO_HIGHERTAXON$Spinivesica crypticus$	Spinivesica sp_ms_crypticus
   16$_NO_HIGHERTAXON$Spinivesica decipiens$	Spinivesica sp_ms_decipiens
  120$_NO_HIGHERTAXON$Spinivesica eremophilicola$	Spinivesica sp_ms_eremophilicola
  409$_NO_HIGHERTAXON$Spinivesica eremophiloides$	Spinivesica sp_ms_eremophiloides
    7$_NO_HIGHERTAXON$Spinivesica mardathuna$	Spinivesica sp_ms_mardathuna
    2$_NO_HIGHERTAXON$Spinivesica pardalotae$	Spinivesica sp_ms_pardalotae
   53$_NO_HIGHERTAXON$Spinivesica spiculata$	Spinivesica sp_ms_spiculata
   57$_NO_HIGHERTAXON$Spinivesica tompricensis$	Spinivesica sp_ms_tompricensis
    1$_NO_HIGHERTAXON$Spinivesica witchelina$	Spinivesica sp_ms_witchelina
    2$_NO_HIGHERTAXON$Stenophyella macreta$	Stenophyella sp_ms_macreta
   17$_NO_HIGHERTAXON$Stenotus binotatus$	Stenotus sp_ms_binotatus
   24$_NO_HIGHERTAXON$Stenotus gressitti$	Stenotus sp_ms_gressitti
    6$_NO_HIGHERTAXON$Stenotus sp.$	Stenotus sp.
   84$_NO_HIGHERTAXON$Stenotus witchelina$	Stenotus sp_ms_witchelina
   13$_NO_HIGHERTAXON$Stenozygum miniatulum$	Stenozygum sp_ms_miniatulum
   98$_NO_HIGHERTAXON$Stephanitis pyrioides$	Stephanitis sp_ms_pyrioides
   59$_NO_HIGHERTAXON$Stephanitis queenslandensis$	Stephanitis sp_ms_queenslandensis
  162$_NO_HIGHERTAXON$Stephanitis sp$	Stephanitis sp
   16$_NO_HIGHERTAXON$Stephanitis sp_01$	Stephanitis sp_01
    8$_NO_HIGHERTAXON$Stephanitis sp_02$	Stephanitis sp_02
   13$_NO_HIGHERTAXON$Stephanitis sp_03$	Stephanitis sp_03
    3$_NO_HIGHERTAXON$Stephanitis sp_04$	Stephanitis sp_04
   17$_NO_HIGHERTAXON$Stephanitis typica$	Stephanitis sp_ms_typica
    6$_NO_HIGHERTAXON$Sthenaridea pacificae$	Sthenaridea sp_ms_pacificae
    4$_NO_HIGHERTAXON$Sthenaridea papuensis$	Sthenaridea sp_ms_papuensis
   44$_NO_HIGHERTAXON$Sthenaridea piceonigra$	Sthenaridea sp_ms_piceonigra
   10$_NO_HIGHERTAXON$Sthenaridea rufescens$	Sthenaridea sp_ms_rufescens
    8$_NO_HIGHERTAXON$Tanybyrsa ampliata$	Tanybyrsa sp_ms_ampliata
   63$_NO_HIGHERTAXON$Tanybyrsa secunda$	Tanybyrsa sp_ms_secunda
    5$_NO_HIGHERTAXON$Tanybyrsa sp$	Tanybyrsa sp
    1$_NO_HIGHERTAXON$Tapeinus sp.$	Tapeinus sp.
   30$_NO_HIGHERTAXON$Taylorilygus apicalis$	Taylorilygus sp_ms_apicalis
    3$_NO_HIGHERTAXON$Tectocoris diophthalmus$	Tectocoris sp_ms_diophthalmus
    5$_NO_HIGHERTAXON$Teddus &#40;MS&#41; payne$	Teddus sp_MS_payne
  153$_NO_HIGHERTAXON$Teleonemia scrupulosa$	Teleonemia sp_ms_scrupulosa
   28$_NO_HIGHERTAXON$Teleonemia sp.$	Teleonemia sp.
   85$_NO_HIGHERTAXON$Telophylus eremophilae$	Telophylus sp_ms_eremophilae
   12$_NO_HIGHERTAXON$Telophylus nanutarra$	Telophylus sp_ms_nanutarra
    1$_NO_HIGHERTAXON$Termatomiris proboscidocoris$	Termatomiris sp_ms_proboscidocoris
   16$_NO_HIGHERTAXON$Termatophylum sp.$	Termatophylum sp.
    2$_NO_HIGHERTAXON$Thaumastocoris australicus$	Thaumastocoris sp_ms_australicus
    1$_NO_HIGHERTAXON$Thermus nigroruber$	Thermus sp_ms_nigroruber
   53$_NO_HIGHERTAXON$Tholosanus proximus$	Tholosanus sp_ms_proximus
   14$_NO_HIGHERTAXON$Tholosanus sp.$	Tholosanus sp.
   49$_NO_HIGHERTAXON$Thryptomenomiris kalbarri$	Thryptomenomiris sp_ms_kalbarri
   32$_NO_HIGHERTAXON$Thryptomenomiris yalgoo$	Thryptomenomiris sp_ms_yalgoo
   42$_NO_HIGHERTAXON$Tingis drakei$	Tingis sp_ms_drakei
    2$_NO_HIGHERTAXON$Tingis hackeri$	Tingis sp_ms_hackeri
    9$_NO_HIGHERTAXON$Tingis perkensi$	Tingis sp_ms_perkensi
    1$_NO_HIGHERTAXON$Tingis sp_01_drakei$	Tingis sp_01_drakei
    6$_NO_HIGHERTAXON$Tingis sp_02$	Tingis sp_02
    4$_NO_HIGHERTAXON$Tingis sp_ms_boronia$	Tingis sp_ms_boronia
    1$_NO_HIGHERTAXON$Tingis sp_ms_charlottespass$	Tingis sp_ms_charlottespass
    1$_NO_HIGHERTAXON$Tingis sp_ms_gosford$	Tingis sp_ms_gosford
    3$_NO_HIGHERTAXON$Tingis sp_nt$	Tingis sp_nt
    5$_NO_HIGHERTAXON$Transleucophoroptera philippinensis$	Transleucophoroptera sp_ms_philippinensis
    5$_NO_HIGHERTAXON$Trichocephalocapsus albofasciatus$	Trichocephalocapsus sp_ms_albofasciatus
    3$_NO_HIGHERTAXON$Trichocephalocapsus immaculatus$	Trichocephalocapsus sp_ms_immaculatus
    2$_NO_HIGHERTAXON$Trichocephalocapsus sp.$	Trichocephalocapsus sp.
    1$_NO_HIGHERTAXON$Trichophorella papuana$	Trichophorella sp_ms_papuana
   14$_NO_HIGHERTAXON$Trigonotylus tenuis$	Trigonotylus sp_ms_tenuis
    1$_NO_HIGHERTAXON$Trisecus pictus$	Trisecus sp_ms_pictus
    1$_NO_HIGHERTAXON$Tylocryptus eugenus$	Tylocryptus sp_ms_eugenus
   20$_NO_HIGHERTAXON$Tytthus chinensis$	Tytthus sp_ms_chinensis
    3$_NO_HIGHERTAXON$Tytthus mundulus$	Tytthus sp_ms_mundulus
    1$_NO_HIGHERTAXON$Tytthus sp.$	Tytthus sp.
   20$_NO_HIGHERTAXON$Udeocoris nigroaeneus$	Udeocoris sp_ms_nigroaeneus
   24$_NO_HIGHERTAXON$Udeocoris rolandi$	Udeocoris sp_ms_rolandi
   24$_NO_HIGHERTAXON$Udeocoris scudderi$	Udeocoris sp_ms_scudderi
   50$_NO_HIGHERTAXON$Ulonemia mjobergi$	Ulonemia sp_ms_mjobergi
    1$_NO_HIGHERTAXON$Ulonemia sp.$	Ulonemia sp.
    2$_NO_HIGHERTAXON$Undetermined sp.$	Undetermined sp.
   24$_NO_HIGHERTAXON$Unknown unknown$	Unknown sp_ms_unknown
   69$_NO_HIGHERTAXON$Urentius sarinae$	Urentius sp_ms_sarinae
    1$_NO_HIGHERTAXON$Vanniopsis crobylos$	Vanniopsis sp_ms_crobylos
    1$_NO_HIGHERTAXON$Voconia erima$	Voconia sp_ms_erima
    1$_NO_HIGHERTAXON$Voconia furvipes$	Voconia sp_ms_furvipes
    2$_NO_HIGHERTAXON$Voconia minor$	Voconia sp_ms_minor
    4$_NO_HIGHERTAXON$Voconia pallidipes$	Voconia sp_ms_pallidipes
    1$_NO_HIGHERTAXON$Voconia perlucida$	Voconia sp_ms_perlucida
   11$_NO_HIGHERTAXON$Voconia tuberculatus$	Voconia sp_ms_tuberculatus
    2$_NO_HIGHERTAXON$Volkeliopsis sp_ms_mindanao$	Volkeliopsis sp_ms_mindanao
    1$_NO_HIGHERTAXON$Volkelius sp.$	Volkelius sp.
   14$_NO_HIGHERTAXON$Volkelius sp_ms_carvalhoi$	Volkelius sp_ms_carvalhoi
    6$_NO_HIGHERTAXON$Volkelius sp_ms_maculatus$	Volkelius sp_ms_maculatus
    1$_NO_HIGHERTAXON$Volkelius sp_ms_niger$	Volkelius sp_ms_niger
    5$_NO_HIGHERTAXON$Volkelius sulcatus$	Volkelius sp_ms_sulcatus
    9$_NO_HIGHERTAXON$Wallabicoris baldersoni$	Wallabicoris sp_ms_baldersoni
  111$_NO_HIGHERTAXON$Wallabicoris cassisi$	Wallabicoris sp_ms_cassisi
   63$_NO_HIGHERTAXON$Wallabicoris chrysocephali$	Wallabicoris sp_ms_chrysocephali
    3$_NO_HIGHERTAXON$Wallabicoris commoni$	Wallabicoris sp_ms_commoni
    2$_NO_HIGHERTAXON$Wallabicoris coolabah$	Wallabicoris sp_ms_coolabah
    7$_NO_HIGHERTAXON$Wallabicoris craspedii$	Wallabicoris sp_ms_craspedii
   52$_NO_HIGHERTAXON$Wallabicoris cuneotinctus$	Wallabicoris sp_ms_cuneotinctus
  195$_NO_HIGHERTAXON$Wallabicoris dicrastyli$	Wallabicoris sp_ms_dicrastyli
  108$_NO_HIGHERTAXON$Wallabicoris ellae$	Wallabicoris sp_ms_ellae
    5$_NO_HIGHERTAXON$Wallabicoris gingera$	Wallabicoris sp_ms_gingera
   28$_NO_HIGHERTAXON$Wallabicoris halganii$	Wallabicoris sp_ms_halganii
   49$_NO_HIGHERTAXON$Wallabicoris helichrysi$	Wallabicoris sp_ms_helichrysi
  348$_NO_HIGHERTAXON$Wallabicoris lachnostachyos$	Wallabicoris sp_ms_lachnostachyos
   12$_NO_HIGHERTAXON$Wallabicoris maralinga$	Wallabicoris sp_ms_maralinga
  197$_NO_HIGHERTAXON$Wallabicoris newcastelii$	Wallabicoris sp_ms_newcastelii
    2$_NO_HIGHERTAXON$Wallabicoris norsemanius$	Wallabicoris sp_ms_norsemanius
    5$_NO_HIGHERTAXON$Wallabicoris olearii$	Wallabicoris sp_ms_olearii
  344$_NO_HIGHERTAXON$Wallabicoris ozothamni$	Wallabicoris sp_ms_ozothamni
   55$_NO_HIGHERTAXON$Wallabicoris paradicrastyli$	Wallabicoris sp_ms_paradicrastyli
   25$_NO_HIGHERTAXON$Wallabicoris pimelei$	Wallabicoris sp_ms_pimelei
  275$_NO_HIGHERTAXON$Wallabicoris pinocchii$	Wallabicoris sp_ms_pinocchii
   74$_NO_HIGHERTAXON$Wallabicoris pityrodiellus$	Wallabicoris sp_ms_pityrodiellus
  439$_NO_HIGHERTAXON$Wallabicoris pityrodii$	Wallabicoris sp_ms_pityrodii
   26$_NO_HIGHERTAXON$Wallabicoris pomaderri$	Wallabicoris sp_ms_pomaderri
   20$_NO_HIGHERTAXON$Wallabicoris prostantheri$	Wallabicoris sp_ms_prostantheri
  373$_NO_HIGHERTAXON$Wallabicoris pultenaei$	Wallabicoris sp_ms_pultenaei
   67$_NO_HIGHERTAXON$Wallabicoris rhamnicola$	Wallabicoris sp_ms_rhamnicola
  414$_NO_HIGHERTAXON$Wallabicoris rutidosi$	Wallabicoris sp_ms_rutidosi
   14$_NO_HIGHERTAXON$Wallabicoris sandstonensis$	Wallabicoris sp_ms_sandstonensis
  112$_NO_HIGHERTAXON$Wallabicoris schwartzi$	Wallabicoris sp_ms_schwartzi
   13$_NO_HIGHERTAXON$Wallabicoris sp.$	Wallabicoris sp.
   98$_NO_HIGHERTAXON$Wallabicoris spyridiellus$	Wallabicoris sp_ms_spyridiellus
  234$_NO_HIGHERTAXON$Wallabicoris spyridii$	Wallabicoris sp_ms_spyridii
   82$_NO_HIGHERTAXON$Wallabicoris tasmanensis$	Wallabicoris sp_ms_tasmanensis
   69$_NO_HIGHERTAXON$Wallabicoris thomasii$	Wallabicoris sp_ms_thomasii
    9$_NO_HIGHERTAXON$Wallabicoris trymalii$	Wallabicoris sp_ms_trymalii
    3$_NO_HIGHERTAXON$Wallabicoris uptoni$	Wallabicoris sp_ms_uptoni
  621$_NO_HIGHERTAXON$Wallabicoris waitzii$	Wallabicoris sp_ms_waitzii
   10$_NO_HIGHERTAXON$Watarrkamiris pallidus$	Watarrkamiris sp_ms_pallidus
    3$_NO_HIGHERTAXON$Watarrkamiris serpentinae$	Watarrkamiris sp_ms_serpentinae
    1$_NO_HIGHERTAXON$Watarrkamiris sp_n_nr_pallidus$	Watarrkamiris sp_n_nr_pallidus
    6$_NO_HIGHERTAXON$Waterhouseana delicata$	Waterhouseana sp_ms_delicata
    6$_NO_HIGHERTAXON$Waterhouseana illustris$	Waterhouseana sp_ms_illustris
    4$_NO_HIGHERTAXON$Witchelinamiris mchughi$	Witchelinamiris sp_ms_mchughi
    2$_NO_HIGHERTAXON$Witchelinamiris sp.$	Witchelinamiris sp.
   12$_NO_HIGHERTAXON$Witchelinamiris viridimaculatus$	Witchelinamiris sp_ms_viridimaculatus
    7$_NO_HIGHERTAXON$Woodwardiola sp_s001$	Woodwardiola sp_s001
    2$_NO_HIGHERTAXON$Wumea cassisi$	Wumea sp_ms_cassisi
   12$_NO_HIGHERTAXON$Wumea clypealis$	Wumea sp_ms_clypealis
    3$_NO_HIGHERTAXON$Wumea ms_np14$	Wumea sp_ms_np14
    4$_NO_HIGHERTAXON$Xenotingis papuana$	Xenotingis sp_ms_papuana
    2$_NO_HIGHERTAXON$Xenotingis sp.$	Xenotingis sp.
  145$_NO_HIGHERTAXON$Xiphoidellus aureus$	Xiphoidellus sp_ms_aureus
  207$_NO_HIGHERTAXON$Xiphoidellus dumosus$	Xiphoidellus sp_ms_dumosus
  459$_NO_HIGHERTAXON$Xiphoidellus furvus$	Xiphoidellus sp_ms_furvus
  222$_NO_HIGHERTAXON$Xiphoidellus gilvus$	Xiphoidellus sp_ms_gilvus
  401$_NO_HIGHERTAXON$Xiphoidellus pallidus$	Xiphoidellus sp_ms_pallidus
  224$_NO_HIGHERTAXON$Xiphoidellus unicolor$	Xiphoidellus sp_ms_unicolor
    4$_NO_HIGHERTAXON$Xiphoides badius$	Xiphoides sp_ms_badius
    3$_NO_HIGHERTAXON$Xiphoides luteolus$	Xiphoides sp_ms_luteolus
    2$_NO_HIGHERTAXON$Xiphoides multicolor$	Xiphoides sp_ms_multicolor
    3$_NO_HIGHERTAXON$Xiphoides myersi$	Xiphoides sp_ms_myersi
    1$_NO_HIGHERTAXON$Xiphoides regis$	Xiphoides sp_ms_regis
  205$_NO_HIGHERTAXON$ZANCH_AUS &#35;1$	ZANCH_AUS sp_1
    1$_NO_HIGHERTAXON$ZANCH_AUS &#35;10$	ZANCH_AUS sp_10
  139$_NO_HIGHERTAXON$ZANCH_AUS &#35;11$	ZANCH_AUS sp_11
   39$_NO_HIGHERTAXON$ZANCH_AUS &#35;12$	ZANCH_AUS sp_12
    3$_NO_HIGHERTAXON$ZANCH_AUS &#35;12a$	ZANCH_AUS sp_12a
    4$_NO_HIGHERTAXON$ZANCH_AUS &#35;12b$	ZANCH_AUS sp_12b
    2$_NO_HIGHERTAXON$ZANCH_AUS &#35;13$	ZANCH_AUS sp_13
   30$_NO_HIGHERTAXON$ZANCH_AUS &#35;14$	ZANCH_AUS sp_14
   17$_NO_HIGHERTAXON$ZANCH_AUS &#35;15$	ZANCH_AUS sp_15
    5$_NO_HIGHERTAXON$ZANCH_AUS &#35;15a$	ZANCH_AUS sp_15a
  101$_NO_HIGHERTAXON$ZANCH_AUS &#35;17$	ZANCH_AUS sp_17
   14$_NO_HIGHERTAXON$ZANCH_AUS &#35;18$	ZANCH_AUS sp_18
    9$_NO_HIGHERTAXON$ZANCH_AUS &#35;19$	ZANCH_AUS sp_19
   24$_NO_HIGHERTAXON$ZANCH_AUS &#35;2$	ZANCH_AUS sp_2
   71$_NO_HIGHERTAXON$ZANCH_AUS &#35;20$	ZANCH_AUS sp_20
    3$_NO_HIGHERTAXON$ZANCH_AUS &#35;21$	ZANCH_AUS sp_21
    2$_NO_HIGHERTAXON$ZANCH_AUS &#35;22$	ZANCH_AUS sp_22
    1$_NO_HIGHERTAXON$ZANCH_AUS &#35;24a$	ZANCH_AUS sp_24a
   34$_NO_HIGHERTAXON$ZANCH_AUS &#35;25$	ZANCH_AUS sp_25
    8$_NO_HIGHERTAXON$ZANCH_AUS &#35;26$	ZANCH_AUS sp_26
    6$_NO_HIGHERTAXON$ZANCH_AUS &#35;30$	ZANCH_AUS sp_30
   18$_NO_HIGHERTAXON$ZANCH_AUS &#35;31$	ZANCH_AUS sp_31
    2$_NO_HIGHERTAXON$ZANCH_AUS &#35;32$	ZANCH_AUS sp_32
    2$_NO_HIGHERTAXON$ZANCH_AUS &#35;33$	ZANCH_AUS sp_33
    4$_NO_HIGHERTAXON$ZANCH_AUS &#35;34$	ZANCH_AUS sp_34
    8$_NO_HIGHERTAXON$ZANCH_AUS &#35;35$	ZANCH_AUS sp_35
    8$_NO_HIGHERTAXON$ZANCH_AUS &#35;4$	ZANCH_AUS sp_4
   31$_NO_HIGHERTAXON$ZANCH_AUS &#35;5$	ZANCH_AUS sp_5
   12$_NO_HIGHERTAXON$ZANCH_AUS &#35;6$	ZANCH_AUS sp_6
   31$_NO_HIGHERTAXON$ZANCH_AUS &#35;7$	ZANCH_AUS sp_7
  104$_NO_HIGHERTAXON$ZANCH_AUS &#35;7a$	ZANCH_AUS sp_7a
   16$_NO_HIGHERTAXON$ZANCH_AUS &#35;7b$	ZANCH_AUS sp_7b
    6$_NO_HIGHERTAXON$ZANCH_AUS &#35;7b1$	ZANCH_AUS sp_7b1
    8$_NO_HIGHERTAXON$ZANCH_AUS &#35;7c$	ZANCH_AUS sp_7c
  102$_NO_HIGHERTAXON$ZANCH_AUS &#35;7e$	ZANCH_AUS sp_7e
    6$_NO_HIGHERTAXON$ZANCH_AUS &#35;7f$	ZANCH_AUS sp_7f
   38$_NO_HIGHERTAXON$ZANCH_AUS &#35;7g$	ZANCH_AUS sp_7g
    1$_NO_HIGHERTAXON$ZANCH_AUS &#35;7g1$	ZANCH_AUS sp_7g1
   76$_NO_HIGHERTAXON$ZANCH_AUS &#35;7i$	ZANCH_AUS sp_7i
    7$_NO_HIGHERTAXON$ZANCH_AUS &#35;8$	ZANCH_AUS sp_8
   11$_NO_HIGHERTAXON$ZANCH_AUS &#35;9$	ZANCH_AUS sp_9
   25$_NO_HIGHERTAXON$ZANCH_NC &#35;1$	ZANCH_NC sp_1
   26$_NO_HIGHERTAXON$ZANCH_NC &#35;2$	ZANCH_NC sp_2
   11$_NO_HIGHERTAXON$ZANCH_NG &#35;2$	ZANCH_NG sp_2
    9$_NO_HIGHERTAXON$ZANCH_NG &#35;3$	ZANCH_NG sp_3
    1$_NO_HIGHERTAXON$ZANCH_NG &#35;4$	ZANCH_NG sp_4
    6$_NO_HIGHERTAXON$Zanchius sp.$	Zanchius sp.
   45$_NO_HIGHERTAXON$Zanessa pictulifer$	Zanessa sp_ms_pictulifer
    6$_NO_HIGHERTAXON$Zanessa rubrovariegata$	Zanessa sp_ms_rubrovariegata
   40$_NO_HIGHERTAXON$Zanessa sp.$	Zanessa sp.
    1$_NO_HIGHERTAXON$Zanessa sp_ms_ararouti$	Zanessa sp_ms_ararouti
    1$_NO_HIGHERTAXON$Zanessa sp_ms_bernarkini$	Zanessa sp_ms_bernarkini
    2$_NO_HIGHERTAXON$Zanessa sp_ms_grossi$	Zanessa sp_ms_grossi
    2$_NO_HIGHERTAXON$Zanessa sp_ms_kulgera$	Zanessa sp_ms_kulgera
    3$_NO_HIGHERTAXON$Zanessa sp_ms_milo$	Zanessa sp_ms_milo
    4$_NO_HIGHERTAXON$Zanessa sp_ms_minor$	Zanessa sp_ms_minor
    1$_NO_HIGHERTAXON$Zanessa sp_ms_nigranotum$	Zanessa sp_ms_nigranotum
    2$_NO_HIGHERTAXON$Zanessa sp_ms_pilosa$	Zanessa sp_ms_pilosa
    6$_NO_HIGHERTAXON$Zanessa sp_ms_punctata$	Zanessa sp_ms_punctata
   10$_NO_HIGHERTAXON$Zanessa sp_ms_rentzi$	Zanessa sp_ms_rentzi
    4$_NO_HIGHERTAXON$Zanessa sp_ms_rubrocuneata$	Zanessa sp_ms_rubrocuneata
    1$_NO_HIGHERTAXON$Zanessa sp_ms_stigmata$	Zanessa sp_ms_stigmata
    1$_NO_HIGHERTAXON$Zanessa sp_ms_wieri$	Zanessa sp_ms_wieri
   18$_NO_HIGHERTAXON$Zanessa sp_nigra$	Zanessa sp_nigra
    1$_NO_HIGHERTAXON$gen. sp_1$	gen. sp_1
   13$_NO_HIGHERTAXON$gen_ms_Bouganvillia sp_ms_brandti$	gen_ms_Bouganvillia sp_ms_brandti
    2$_NO_HIGHERTAXON$gn_ms_nr_falcum ms_k08c$	gn_ms_nr_falcum sp_ms_k08c
   17$_NO_HIGHERTAXON$gn_ms_nr_falcum tasmaniensis$	gn_ms_nr_falcum sp_ms_tasmaniensis
    2$_NO_HIGHERTAXON$undetermined sp.$	undetermined sp.
   12$_NO_HIGHERTAXON$undetermined undetermined$	undetermined sp_ms_undetermined
   28$_NO_HIGHERTAXON$unknown unknown$	unknown sp_ms_unknown
